,polarity_oplexicon,polarity_sentilex,subject,journal,sent_none,sent_neg,sent_pos,sent_neut,opl_none,opl_neg,opl_pos,opl_neut,fileid
0,-13,-14,prisao-lula,estadao,95,14,0,0,85,15,2,7,"acervo.estadao.com.br___noticias_acervo,quatro-ex-presidentes-foram-presos-antes-de-lula,13267,0.htm.txt"
1,-7,0,afastamento-aecio,oglobo,634,10,10,4,535,28,21,74,acervo.oglobo.globo.com___charges-e-humor_da-estreia-como-aecinho-lava-jato-tucano-retratado-em-charges-21552392.txt
2,-17,-6,afastamento-aecio,oglobo,737,14,8,5,610,44,27,83,acervo.oglobo.globo.com___em-destaque_aecio-neves-de-assessor-de-tancredo-governador-senador-ate-lava-jato-21359530.txt
3,-3,1,soltura-lula,oglobo,600,14,15,5,476,37,34,87,blogs.oglobo.globo.com___bernardo-mello-franco_post_collor-diz-que-bolsonaro-corre-risco-de-impeachment.html.txt
4,1,0,prisao-lula,oglobo,43,0,0,1,35,1,2,6,blogs.oglobo.globo.com___bernardo-mello-franco_post_da-cadeia-lula-vai-comentar-copa-para-tv-de-sindicato.html.txt
5,-1,-3,soltura-lula,oglobo,35,3,0,1,26,5,4,4,blogs.oglobo.globo.com___lauro-jardim_post_por-que-bolsonaro-diz-que-lula-e-muito-burro.html.txt
6,4,1,soltura-lula,oglobo,85,2,3,1,67,7,11,6,blogs.oglobo.globo.com___merval-pereira_post_condenacao-de-lula-continua-igual.html.txt
7,5,9,impeachment-dilma,elpais,250,1,10,3,213,13,18,20,brasil.elpais.com___brasil_2015_12_02_politica_1449093380_156718.html.txt
8,12,-8,impeachment-dilma,elpais,374,16,8,6,291,19,31,63,brasil.elpais.com___brasil_2015_12_08_politica_1449576293_761185.html.txt
9,-3,-17,impeachment-dilma,elpais,424,25,8,1,337,33,30,58,brasil.elpais.com___brasil_2015_12_16_opinion_1450265966_724667.html.txt
10,-3,-6,impeachment-dilma,elpais,420,14,8,7,329,30,27,63,brasil.elpais.com___brasil_2016_02_02_politica_1454449234_500788.html.txt
11,5,-11,impeachment-dilma,elpais,555,16,5,6,457,32,37,56,brasil.elpais.com___brasil_2016_03_04_politica_1457115590_947838.html.txt
12,4,4,impeachment-dilma,elpais,357,11,15,3,275,33,37,41,brasil.elpais.com___brasil_2016_03_10_politica_1457613322_994449.html.txt
13,8,-10,impeachment-dilma,elpais,723,27,17,8,606,39,47,83,brasil.elpais.com___brasil_2016_03_13_politica_1457906776_440577.html.txt
14,26,6,impeachment-dilma,elpais,597,7,13,2,501,18,44,56,brasil.elpais.com___brasil_2016_03_17_politica_1458179601_208300.html.txt
15,3,0,impeachment-dilma,elpais,348,8,8,4,264,23,26,55,brasil.elpais.com___brasil_2016_03_18_politica_1458258396_570381.html.txt
16,-2,-1,impeachment-dilma,elpais,508,18,17,7,442,24,22,62,brasil.elpais.com___brasil_2016_03_22_politica_1458666904_690917.html.txt
17,4,2,impeachment-dilma,elpais,442,11,13,2,351,25,29,63,brasil.elpais.com___brasil_2016_03_28_politica_1459189645_411464.html.txt
18,14,-17,impeachment-dilma,elpais,559,22,5,8,442,34,48,70,brasil.elpais.com___brasil_2016_03_30_politica_1459293666_164652.html.txt
19,-3,-1,impeachment-dilma,elpais,432,9,8,7,355,23,20,58,brasil.elpais.com___brasil_2016_03_31_politica_1459383585_301639.html.txt
20,20,-10,impeachment-dilma,elpais,466,19,9,3,376,20,40,61,brasil.elpais.com___brasil_2016_04_01_politica_1459541270_747797.html.txt
21,-16,-3,impeachment-dilma,elpais,518,14,11,2,421,42,26,56,brasil.elpais.com___brasil_2016_04_05_politica_1459812255_649619.html.txt
22,14,6,impeachment-dilma,elpais,423,10,16,6,343,24,38,50,brasil.elpais.com___brasil_2016_04_05_politica_1459872017_590938.html.txt
23,11,1,impeachment-dilma,elpais,575,11,12,4,474,28,39,61,brasil.elpais.com___brasil_2016_04_06_politica_1459978876_935564.html.txt
24,4,-1,impeachment-dilma,elpais,482,6,5,7,384,29,33,54,brasil.elpais.com___brasil_2016_04_08_politica_1460140995_879932.html.txt
25,-4,-1,impeachment-dilma,elpais,418,9,8,7,321,30,26,65,brasil.elpais.com___brasil_2016_04_12_politica_1460430132_131176.html.txt
26,23,-9,impeachment-dilma,elpais,370,31,22,11,312,25,48,49,brasil.elpais.com___brasil_2016_04_12_politica_1460484960_263641.html.txt
27,7,7,impeachment-dilma,elpais,383,4,11,3,309,18,25,49,brasil.elpais.com___brasil_2016_04_15_politica_1460687713_055409.html.txt
28,22,6,impeachment-dilma,elpais,584,13,19,12,451,27,49,101,brasil.elpais.com___brasil_2016_04_15_politica_1460734774_530766.html.txt
29,8,18,impeachment-dilma,elpais,2244,30,48,12,2059,61,69,145,brasil.elpais.com___brasil_2016_04_17_media_1460895657_868124.html.txt
30,-8,-10,impeachment-dilma,elpais,713,22,12,0,596,41,33,77,brasil.elpais.com___brasil_2016_04_17_politica_1460924183_167143.html.txt
31,1,5,impeachment-dilma,elpais,271,9,14,4,212,23,24,39,brasil.elpais.com___brasil_2016_04_18_politica_1460943585_924610.html.txt
32,-5,-15,impeachment-dilma,elpais,905,30,15,6,733,51,46,126,brasil.elpais.com___brasil_2016_04_19_politica_1461019293_721277.html.txt
33,3,0,impeachment-dilma,elpais,351,12,12,1,286,20,23,47,brasil.elpais.com___brasil_2016_04_20_politica_1461184678_726086.html.txt
34,1,-9,impeachment-dilma,elpais,552,16,7,3,457,31,32,58,brasil.elpais.com___brasil_2016_05_06_politica_1462487188_422479.html.txt
35,11,5,impeachment-dilma,elpais,361,18,23,4,297,25,36,48,brasil.elpais.com___brasil_2016_05_10_politica_1462835274_205462.html.txt
36,10,-6,impeachment-dilma,elpais,577,19,13,4,483,32,42,56,brasil.elpais.com___brasil_2016_05_10_politica_1462910494_551515.html.txt
37,7,4,impeachment-dilma,elpais,146,0,4,0,132,0,7,11,brasil.elpais.com___brasil_2016_05_11_politica_1462991169_808675.html.txt
38,32,25,impeachment-dilma,elpais,778,18,43,3,650,38,70,84,brasil.elpais.com___brasil_2016_05_11_politica_1462997495_675228.html.txt
39,1,-7,impeachment-dilma,elpais,208,7,0,1,157,14,15,30,brasil.elpais.com___brasil_2016_05_12_internacional_1463053024_876025.html.txt
40,39,-19,impeachment-dilma,elpais,819,40,21,5,626,41,80,138,brasil.elpais.com___brasil_2016_05_12_politica_1463017113_667226.html.txt
41,1,11,impeachment-dilma,elpais,242,2,13,2,198,18,19,24,brasil.elpais.com___brasil_2016_05_19_politica_1463679369_944371.html.txt
42,11,-5,impeachment-dilma,elpais,377,13,8,3,312,18,29,42,brasil.elpais.com___brasil_2016_05_23_politica_1464033744_760409.html.txt
43,-1,-2,impeachment-dilma,elpais,239,6,4,3,200,15,14,23,brasil.elpais.com___brasil_2016_06_08_politica_1465401227_020297.html.txt
44,4,-9,impeachment-dilma,elpais,575,19,10,6,431,55,59,65,brasil.elpais.com___brasil_2016_06_10_politica_1465589880_428444.html.txt
45,4,9,impeachment-dilma,elpais,481,6,15,3,390,33,37,45,brasil.elpais.com___brasil_2016_06_27_politica_1467040634_118457.html.txt
46,6,-3,impeachment-dilma,elpais,142,8,5,1,122,7,13,14,brasil.elpais.com___brasil_2016_07_01_politica_1467377006_399517.html.txt
47,8,2,impeachment-dilma,elpais,164,3,5,2,119,9,17,29,brasil.elpais.com___brasil_2016_08_09_internacional_1470754391_492099.html.txt
48,-14,-8,impeachment-dilma,elpais,381,11,3,1,305,31,17,43,brasil.elpais.com___brasil_2016_08_10_politica_1470784384_557956.html.txt
49,15,24,impeachment-dilma,elpais,681,25,49,7,515,57,72,118,brasil.elpais.com___brasil_2016_08_16_politica_1471370577_438351.html.txt
50,9,-1,impeachment-dilma,elpais,606,15,14,3,479,31,40,88,brasil.elpais.com___brasil_2016_08_20_politica_1471655801_573594.html.txt
51,-3,-8,impeachment-dilma,elpais,470,13,5,4,391,30,27,44,brasil.elpais.com___brasil_2016_08_27_politica_1472257804_067144.html.txt
52,1,-1,impeachment-dilma,elpais,594,12,11,4,479,36,37,69,brasil.elpais.com___brasil_2016_08_30_politica_1472516314_396319.html.txt
53,0,-1,impeachment-dilma,elpais,76,2,1,0,65,4,4,6,brasil.elpais.com___brasil_2016_08_30_politica_1472559177_490168.html.txt
54,-12,-8,impeachment-dilma,elpais,369,18,10,2,295,35,23,46,brasil.elpais.com___brasil_2016_08_31_opinion_1472650538_750062.html.txt
55,15,11,impeachment-dilma,elpais,353,2,13,4,272,20,35,45,brasil.elpais.com___brasil_2016_08_31_politica_1472676017_457817.html.txt
56,27,4,impeachment-dilma,elpais,484,13,17,2,368,22,49,77,brasil.elpais.com___brasil_2016_09_01_politica_1472682956_242080.html.txt
57,-3,-1,impeachment-dilma,elpais,238,3,2,1,208,8,5,23,brasil.elpais.com___brasil_2016_09_01_politica_1472698540_990899.html.txt
58,8,5,impeachment-dilma,elpais,332,3,8,2,251,21,29,44,brasil.elpais.com___brasil_2016_09_07_internacional_1473281921_337121.html.txt
59,-4,-6,impeachment-dilma,elpais,401,9,3,3,308,22,18,68,brasil.elpais.com___brasil_2016_09_10_politica_1473459058_393103.html.txt
60,7,-5,afastamento-aecio,elpais,234,8,3,0,189,13,20,23,brasil.elpais.com___brasil_2017_03_02_politica_1488465624_752767.html.txt
61,2,-7,reforma-trabalhista,elpais,371,15,8,1,289,23,25,58,brasil.elpais.com___brasil_2017_03_03_politica_1488567662_626759.html.txt
62,-7,6,reforma-trabalhista,elpais,354,5,11,0,293,22,15,40,brasil.elpais.com___brasil_2017_03_14_politica_1489527515_791102.html.txt
63,33,11,reforma-trabalhista,elpais,557,8,19,1,426,22,55,82,brasil.elpais.com___brasil_2017_03_21_politica_1490127891_298981.html.txt
64,8,0,reforma-trabalhista,elpais,831,9,9,9,613,49,57,139,brasil.elpais.com___brasil_2017_03_29_opinion_1490806331_286763.html.txt
65,3,-10,reforma-trabalhista,elpais,271,11,1,2,215,12,15,43,brasil.elpais.com___brasil_2017_03_30_politica_1490900263_754660.html.txt
66,2,-7,reforma-trabalhista,elpais,354,17,10,2,296,20,22,45,brasil.elpais.com___brasil_2017_04_01_politica_1491007616_060512.html.txt
67,3,9,reforma-trabalhista,elpais,324,1,10,4,243,18,21,57,brasil.elpais.com___brasil_2017_04_18_politica_1492538007_595666.html.txt
68,16,1,reforma-trabalhista,elpais,407,7,8,1,314,16,32,61,brasil.elpais.com___brasil_2017_04_21_economia_1492726431_998946.html.txt
69,15,1,reforma-trabalhista,elpais,616,11,12,1,474,28,43,95,brasil.elpais.com___brasil_2017_04_22_politica_1492814264_277616.html.txt
70,51,27,reforma-trabalhista,elpais,1039,17,44,5,840,46,97,122,brasil.elpais.com___brasil_2017_04_25_politica_1493074533_442768.html.txt
71,25,-4,reforma-trabalhista,elpais,830,10,6,1,669,24,49,105,brasil.elpais.com___brasil_2017_04_25_politica_1493142273_498795.html.txt
72,0,0,reforma-trabalhista,elpais,425,6,6,0,338,20,20,59,brasil.elpais.com___brasil_2017_04_26_politica_1493228744_734088.html.txt
73,23,4,reforma-trabalhista,elpais,620,15,19,5,500,29,52,78,brasil.elpais.com___brasil_2017_04_26_politica_1493239710_815493.html.txt
74,4,-7,reforma-trabalhista,elpais,568,20,13,5,454,30,34,88,brasil.elpais.com___brasil_2017_04_27_internacional_1493296487_352960.html.txt
75,10,13,reforma-trabalhista,elpais,315,9,22,4,238,29,39,44,brasil.elpais.com___brasil_2017_04_27_politica_1493248308_190135.html.txt
76,26,0,reforma-trabalhista,elpais,751,8,8,2,627,20,46,76,brasil.elpais.com___brasil_2017_04_27_politica_1493303188_266659.html.txt
77,-1,0,reforma-trabalhista,elpais,13,0,0,0,10,1,0,2,brasil.elpais.com___brasil_2017_04_28_album_1493370617_756920.html.txt
78,0,-1,reforma-trabalhista,elpais,252,6,5,2,190,18,18,39,brasil.elpais.com___brasil_2017_04_28_politica_1493403387_106996.html.txt
79,13,-1,reforma-trabalhista,elpais,208,9,8,0,153,7,20,45,brasil.elpais.com___brasil_2017_05_01_actualidad_1493660125_039251.html.txt
80,5,-1,reforma-trabalhista,elpais,1199,41,40,10,937,86,91,176,brasil.elpais.com___brasil_2017_05_01_opinion_1493666728_748294.html.txt
81,13,2,reforma-trabalhista,elpais,358,10,12,3,280,18,31,54,brasil.elpais.com___brasil_2017_05_01_politica_1493667036_221043.html.txt
82,15,2,reforma-trabalhista,elpais,430,3,5,2,329,14,29,68,brasil.elpais.com___brasil_2017_05_04_politica_1493852422_954101.html.txt
83,28,7,reforma-trabalhista,elpais,626,12,19,7,528,18,46,72,brasil.elpais.com___brasil_2017_05_04_politica_1493927909_366887.html.txt
84,11,-20,reforma-trabalhista,elpais,569,37,17,5,463,37,48,80,brasil.elpais.com___brasil_2017_05_11_politica_1494531783_848435.html.txt
85,5,-9,reforma-trabalhista,elpais,473,20,11,4,397,20,25,66,brasil.elpais.com___brasil_2017_05_18_economia_1495143459_395778.html.txt
86,-2,-7,afastamento-aecio,elpais,270,10,3,1,221,20,18,25,brasil.elpais.com___brasil_2017_05_18_politica_1495105098_952902.html.txt
87,6,-1,afastamento-aecio,elpais,305,5,4,1,244,13,19,39,brasil.elpais.com___brasil_2017_05_19_deportes_1495208129_874657.html.txt
88,-1,-1,afastamento-aecio,elpais,263,8,7,3,206,19,18,38,brasil.elpais.com___brasil_2017_05_22_politica_1495471262_064279.html.txt
89,-4,-9,afastamento-aecio,elpais,729,21,12,7,611,43,39,76,brasil.elpais.com___brasil_2017_05_22_politica_1495479650_984383.html.txt
90,18,12,afastamento-aecio,elpais,566,5,17,7,462,21,39,73,brasil.elpais.com___brasil_2017_05_24_politica_1495659673_925165.html.txt
91,-4,-7,afastamento-aecio,elpais,433,18,11,3,367,31,27,40,brasil.elpais.com___brasil_2017_05_30_politica_1496177290_569617.html.txt
92,8,-12,afastamento-aecio,elpais,492,19,7,1,407,31,39,42,brasil.elpais.com___brasil_2017_06_01_politica_1496345795_415837.html.txt
93,44,12,reforma-trabalhista,elpais,714,9,21,3,542,28,72,105,brasil.elpais.com___brasil_2017_06_16_economia_1497635788_119553.html.txt
94,15,-7,reforma-trabalhista,elpais,454,18,11,0,369,19,34,61,brasil.elpais.com___brasil_2017_06_20_politica_1497989756_924547.html.txt
95,6,-2,reforma-trabalhista,elpais,353,5,3,0,281,16,22,42,brasil.elpais.com___brasil_2017_06_21_deportes_1497997158_880136.html.txt
96,0,-4,afastamento-aecio,elpais,184,7,3,1,158,12,12,13,brasil.elpais.com___brasil_2017_06_24_politica_1498256541_276454.html.txt
97,4,-3,reforma-trabalhista,elpais,414,8,5,1,343,18,22,45,brasil.elpais.com___brasil_2017_06_29_politica_1498748829_852994.html.txt
98,1,0,afastamento-aecio,elpais,227,5,5,3,190,16,17,17,brasil.elpais.com___brasil_2017_06_30_politica_1498834680_138529.html.txt
99,6,-7,afastamento-aecio,elpais,577,19,12,6,461,39,45,69,brasil.elpais.com___brasil_2017_07_01_politica_1498929668_859837.html.txt
100,10,1,afastamento-aecio,elpais,325,8,9,3,273,15,25,32,brasil.elpais.com___brasil_2017_07_06_politica_1499355819_599478.html.txt
101,24,11,reforma-trabalhista,elpais,547,7,18,4,433,28,52,63,brasil.elpais.com___brasil_2017_07_13_politica_1499958789_546835.html.txt
102,7,-15,reforma-trabalhista,elpais,1270,50,35,12,951,88,95,233,brasil.elpais.com___brasil_2017_07_21_economia_1500671743_676963.html.txt
103,65,-6,reforma-trabalhista,elpais,1235,31,25,16,885,76,141,205,brasil.elpais.com___brasil_2017_08_04_politica_1501799787_669833.html.txt
104,13,-4,reforma-trabalhista,elpais,524,14,10,2,430,30,43,47,brasil.elpais.com___brasil_2017_08_14_politica_1502721247_786237.html.txt
105,2,-16,afastamento-aecio,elpais,447,18,2,4,352,29,31,59,brasil.elpais.com___brasil_2017_08_19_politica_1503102587_092279.html.txt
106,19,7,reforma-trabalhista,elpais,493,8,15,8,386,22,41,75,brasil.elpais.com___brasil_2017_08_31_internacional_1504172887_983395.html.txt
107,2,-3,afastamento-aecio,elpais,153,5,2,0,132,9,11,8,brasil.elpais.com___brasil_2017_09_27_politica_1506465951_537349.html.txt
108,-1,1,afastamento-aecio,elpais,442,12,13,4,367,29,28,47,brasil.elpais.com___brasil_2017_10_11_politica_1507740544_240494.html.txt
109,-12,-3,afastamento-aecio,elpais,330,14,11,3,268,29,17,44,brasil.elpais.com___brasil_2017_10_17_politica_1508267354_678151.html.txt
110,2,-2,reforma-trabalhista,elpais,538,14,12,3,410,40,42,75,brasil.elpais.com___brasil_2017_11_10_economia_1510331929_272813.html.txt
111,8,-11,reforma-trabalhista,elpais,296,14,3,1,250,14,22,28,brasil.elpais.com___brasil_2017_11_10_opinion_1510318260_752511.html.txt
112,16,7,reforma-trabalhista,elpais,360,8,15,0,299,12,28,44,brasil.elpais.com___brasil_2017_11_10_politica_1510337084_798012.html.txt
113,6,15,reforma-trabalhista,elpais,711,10,25,5,604,39,45,63,brasil.elpais.com___brasil_2017_11_15_economia_1510773029_686202.html.txt
114,15,9,reforma-trabalhista,elpais,389,4,13,2,310,19,34,45,brasil.elpais.com___brasil_2017_11_15_politica_1510702112_772288.html.txt
115,18,4,reforma-trabalhista,elpais,352,3,7,5,267,11,29,60,brasil.elpais.com___brasil_2017_11_22_politica_1511372635_524569.html.txt
116,30,6,reforma-trabalhista,elpais,484,0,6,1,376,12,42,61,brasil.elpais.com___brasil_2017_11_23_politica_1511462959_394417.html.txt
117,-13,-12,prisao-lula,elpais,366,17,5,4,311,33,20,28,brasil.elpais.com___brasil_2018_03_21_politica_1521667364_977847.html.txt
118,-1,-4,prisao-lula,elpais,97,7,3,0,84,8,7,8,brasil.elpais.com___brasil_2018_03_22_politica_1521729755_637601.html.txt
119,2,-23,prisao-lula,elpais,414,29,6,1,349,34,36,31,brasil.elpais.com___brasil_2018_03_22_politica_1521749058_576833.html.txt
120,-4,-2,prisao-lula,elpais,87,2,0,1,73,7,3,7,brasil.elpais.com___brasil_2018_03_26_politica_1522074828_633998.html.txt
121,-6,-6,prisao-lula,elpais,466,15,9,1,387,33,27,44,brasil.elpais.com___brasil_2018_03_26_politica_1522082315_074307.html.txt
122,7,-6,prisao-lula,elpais,739,22,16,6,590,43,50,100,brasil.elpais.com___brasil_2018_03_26_politica_1522086274_176444.html.txt
123,-1,-5,prisao-lula,elpais,724,17,12,4,640,28,27,62,brasil.elpais.com___brasil_2018_03_28_politica_1522246580_512544.html.txt
124,-4,-30,prisao-lula,elpais,819,47,17,5,695,59,55,79,brasil.elpais.com___brasil_2018_04_03_politica_1522765227_879037.html.txt
125,-3,-4,prisao-lula,elpais,133,7,3,0,115,11,8,9,brasil.elpais.com___brasil_2018_04_03_politica_1522781676_848505.html.txt
126,-1,-3,prisao-lula,elpais,629,24,21,3,524,37,36,80,brasil.elpais.com___brasil_2018_04_04_politica_1522803698_804414.html.txt
127,13,-22,prisao-lula,elpais,706,41,19,3,576,44,57,92,brasil.elpais.com___brasil_2018_04_04_politica_1522869590_474972.html.txt
128,1,-14,prisao-lula,elpais,374,26,12,1,321,28,29,35,brasil.elpais.com___brasil_2018_04_04_politica_1522878768_532763.html.txt
129,-10,-43,prisao-lula,elpais,1315,65,22,9,1146,69,59,137,brasil.elpais.com___brasil_2018_04_05_politica_1522917041_563602.html.txt
130,6,0,prisao-lula,elpais,84,2,2,1,68,3,9,9,brasil.elpais.com___brasil_2018_04_05_politica_1522963303_065710.html.txt
131,3,3,prisao-lula,elpais,478,10,13,1,391,32,35,44,brasil.elpais.com___brasil_2018_04_06_politica_1522966312_016125.html.txt
132,-14,-8,prisao-lula,elpais,351,16,8,1,295,34,20,27,brasil.elpais.com___brasil_2018_04_06_politica_1522966647_821554.html.txt
133,9,1,prisao-lula,elpais,375,14,15,4,307,21,30,50,brasil.elpais.com___brasil_2018_04_06_politica_1523033454_739753.html.txt
134,8,-25,prisao-lula,elpais,446,33,8,1,398,29,37,24,brasil.elpais.com___brasil_2018_04_06_politica_1523050291_534837.html.txt
135,-1,-3,prisao-lula,elpais,14,3,0,0,16,1,0,0,brasil.elpais.com___brasil_2018_04_08_album_1523143632_613898.html.txt
136,5,-9,prisao-lula,elpais,515,24,15,5,393,44,49,73,brasil.elpais.com___brasil_2018_04_08_politica_1523145272_467301.html.txt
137,46,7,prisao-lula,elpais,1970,80,87,19,1578,130,176,272,brasil.elpais.com___brasil_2018_04_09_politica_1523288070_346855.html.txt
138,-3,-10,prisao-lula,elpais,461,18,8,5,390,28,25,49,brasil.elpais.com___brasil_2018_04_10_politica_1523382639_997189.html.txt
139,1,-10,prisao-lula,elpais,354,24,14,5,267,38,39,53,brasil.elpais.com___brasil_2018_04_10_politica_1523397285_097805.html.txt
140,-2,-11,prisao-lula,elpais,347,23,12,9,273,35,33,50,brasil.elpais.com___brasil_2018_04_12_opinion_1523564591_777993.html.txt
141,12,12,prisao-lula,elpais,552,22,34,5,431,39,51,92,brasil.elpais.com___brasil_2018_04_13_opinion_1523620881_400713.html.txt
142,13,-22,prisao-lula,elpais,656,28,6,1,551,31,44,65,brasil.elpais.com___brasil_2018_04_13_politica_1523629735_484727.html.txt
143,2,-12,prisao-lula,elpais,337,14,2,5,288,16,18,36,brasil.elpais.com___brasil_2018_04_14_politica_1523729933_579711.html.txt
144,-5,-5,prisao-lula,elpais,368,18,13,3,303,31,26,42,brasil.elpais.com___brasil_2018_04_16_politica_1523883729_575620.html.txt
145,1,-12,prisao-lula,elpais,517,19,7,2,407,38,39,61,brasil.elpais.com___brasil_2018_04_17_politica_1523982512_260960.html.txt
146,-4,-2,prisao-lula,elpais,126,4,2,1,112,7,3,11,brasil.elpais.com___brasil_2018_04_17_politica_1523996475_699405.html.txt
147,22,-15,prisao-lula,elpais,450,22,7,1,382,19,41,38,brasil.elpais.com___brasil_2018_04_17_politica_1524000623_559794.html.txt
148,-9,-2,prisao-lula,elpais,380,21,19,4,341,26,17,40,brasil.elpais.com___brasil_2018_04_26_politica_1524693896_904880.html.txt
149,0,-2,prisao-lula,elpais,782,29,27,1,650,53,53,83,brasil.elpais.com___brasil_2018_04_27_opinion_1524780731_282172.html.txt
150,11,12,prisao-lula,elpais,609,14,26,11,499,37,48,76,brasil.elpais.com___brasil_2018_05_04_politica_1525450574_426616.html.txt
151,9,-7,prisao-lula,elpais,337,15,8,2,296,16,25,25,brasil.elpais.com___brasil_2018_05_11_politica_1525993566_602121.html.txt
152,1,-3,prisao-lula,elpais,112,4,1,0,104,2,3,8,brasil.elpais.com___brasil_2018_05_14_politica_1526313397_289889.html.txt
153,-4,-6,prisao-lula,elpais,182,9,3,1,139,14,10,32,brasil.elpais.com___brasil_2018_05_16_opinion_1526496010_352483.html.txt
154,17,-8,prisao-lula,elpais,550,19,11,5,432,32,49,72,brasil.elpais.com___brasil_2018_05_25_internacional_1527247722_723152.html.txt
155,11,-2,prisao-lula,elpais,261,17,15,6,218,23,34,24,brasil.elpais.com___brasil_2018_06_15_opinion_1529073609_286008.html.txt
156,21,5,prisao-lula,elpais,626,23,28,2,523,35,56,65,brasil.elpais.com___brasil_2018_07_08_politica_1531064107_845443.html.txt
157,5,-9,prisao-lula,elpais,395,20,11,4,337,23,28,42,brasil.elpais.com___brasil_2018_07_10_politica_1531249839_430186.html.txt
158,4,1,reforma-previdencia,elpais,240,1,2,0,174,8,12,49,brasil.elpais.com___brasil_2019_02_14_politica_1550153399_164356.html.txt
159,13,1,reforma-previdencia,elpais,295,5,6,0,240,8,21,37,brasil.elpais.com___brasil_2019_02_20_politica_1550665728_241052.html.txt
160,16,-2,reforma-previdencia,elpais,611,7,5,4,483,19,35,90,brasil.elpais.com___brasil_2019_02_20_politica_1550676678_385935.html.txt
161,13,1,reforma-previdencia,elpais,398,7,8,1,324,19,32,39,brasil.elpais.com___brasil_2019_02_20_politica_1550684558_009836.html.txt
162,24,9,reforma-previdencia,elpais,342,12,21,3,270,14,38,56,brasil.elpais.com___brasil_2019_02_27_internacional_1551284780_172281.html.txt
163,0,0,reforma-previdencia,elpais,0,0,0,0,0,0,0,0,brasil.elpais.com___brasil_2019_03_21_politica_1553128586_781216.html.txt
164,-5,1,reforma-previdencia,elpais,368,5,6,4,288,26,21,48,brasil.elpais.com___brasil_2019_03_27_politica_1553642262_663695.html.txt
165,11,0,reforma-previdencia,elpais,361,8,8,2,277,15,26,61,brasil.elpais.com___brasil_2019_03_28_politica_1553783247_132819.html.txt
166,14,2,reforma-previdencia,elpais,467,3,5,2,333,21,35,88,brasil.elpais.com___brasil_2019_04_03_politica_1554243545_893051.html.txt
167,2,2,reforma-previdencia,elpais,169,1,3,1,128,10,12,24,brasil.elpais.com___brasil_2019_04_03_politica_1554306984_314990.html.txt
168,-12,-10,soltura-lula,elpais,549,21,11,1,446,42,30,64,brasil.elpais.com___brasil_2019_04_05_politica_1554495483_053081.html.txt
169,3,3,reforma-previdencia,elpais,186,1,4,3,142,11,14,27,brasil.elpais.com___brasil_2019_04_09_politica_1554829618_536224.html.txt
170,-2,-2,reforma-previdencia,elpais,280,8,6,2,222,18,16,40,brasil.elpais.com___brasil_2019_04_16_politica_1555435394_456546.html.txt
171,-2,-4,reforma-previdencia,elpais,435,9,5,5,351,28,26,49,brasil.elpais.com___brasil_2019_04_24_politica_1556069205_678365.html.txt
172,5,1,reforma-previdencia,elpais,350,5,6,0,270,17,22,52,brasil.elpais.com___brasil_2019_05_01_politica_1556736036_111232.html.txt
173,16,-2,reforma-previdencia,elpais,452,18,16,6,330,35,51,76,brasil.elpais.com___brasil_2019_05_04_opinion_1557004970_457239.html.txt
174,31,10,reforma-previdencia,elpais,1311,18,28,13,985,87,118,180,brasil.elpais.com___brasil_2019_05_13_politica_1557776028_131882.html.txt
175,2,-10,reforma-previdencia,elpais,434,19,9,7,340,25,27,77,brasil.elpais.com___brasil_2019_05_21_politica_1558444389_943589.html.txt
176,20,-3,soltura-lula,elpais,442,14,11,6,353,19,39,62,brasil.elpais.com___brasil_2019_05_24_politica_1558716869_495068.html.txt
177,7,-1,reforma-previdencia,elpais,530,12,11,3,416,26,33,81,brasil.elpais.com___brasil_2019_05_24_politica_1558728044_580166.html.txt
178,-1,0,reforma-previdencia,elpais,389,6,6,3,303,18,17,66,brasil.elpais.com___brasil_2019_05_30_economia_1559249875_744795.html.txt
179,29,6,reforma-previdencia,elpais,773,5,11,2,594,36,65,96,brasil.elpais.com___brasil_2019_06_04_politica_1559606467_397200.html.txt
180,-6,4,reforma-previdencia,elpais,340,3,7,4,285,22,16,31,brasil.elpais.com___brasil_2019_06_11_politica_1560288422_885150.html.txt
181,30,11,reforma-previdencia,elpais,899,5,16,3,711,30,60,122,brasil.elpais.com___brasil_2019_06_13_politica_1560460971_232201.html.txt
182,22,12,reforma-previdencia,elpais,674,5,17,3,550,26,48,75,brasil.elpais.com___brasil_2019_06_14_politica_1560535520_728346.html.txt
183,0,-1,soltura-lula,elpais,118,7,6,1,107,9,9,7,brasil.elpais.com___brasil_2019_06_25_politica_1561486216_484958.html.txt
184,14,-2,reforma-previdencia,elpais,307,7,5,2,250,13,27,31,brasil.elpais.com___brasil_2019_07_02_politica_1562025480_133184.html.txt
185,5,4,reforma-previdencia,elpais,151,0,4,0,121,7,12,15,brasil.elpais.com___brasil_2019_07_04_politica_1562240232_668933.html.txt
186,12,5,reforma-previdencia,elpais,725,11,16,3,568,41,53,93,brasil.elpais.com___brasil_2019_07_05_politica_1562277830_797738.html.txt
187,3,3,reforma-previdencia,elpais,185,1,4,2,146,7,10,29,brasil.elpais.com___brasil_2019_07_09_politica_1562667588_576954.html.txt
188,18,5,reforma-previdencia,elpais,290,9,14,10,236,9,27,51,brasil.elpais.com___brasil_2019_07_12_opinion_1562888021_465807.html.txt
189,18,3,reforma-previdencia,elpais,440,4,7,1,348,14,32,58,brasil.elpais.com___brasil_2019_07_12_politica_1562895648_549997.html.txt
190,6,-3,reforma-previdencia,elpais,1187,29,26,2,939,72,78,155,brasil.elpais.com___brasil_2019_07_19_politica_1563567581_475934.html.txt
191,25,13,reforma-previdencia,elpais,325,5,18,10,233,15,40,70,brasil.elpais.com___brasil_2019_07_21_opinion_1563668592_132165.html.txt
192,17,-2,reforma-previdencia,elpais,826,14,12,11,635,45,62,121,brasil.elpais.com___brasil_2019_07_29_economia_1564427998_332628.html.txt
193,2,3,reforma-previdencia,elpais,439,5,8,5,343,27,29,58,brasil.elpais.com___brasil_2019_08_07_politica_1565192974_532316.html.txt
194,19,1,reforma-previdencia,elpais,885,8,9,1,691,35,54,123,brasil.elpais.com___brasil_2019_08_09_politica_1565303964_172748.html.txt
195,55,4,reforma-previdencia,elpais,1389,25,29,12,1055,61,116,223,brasil.elpais.com___brasil_2019_08_11_politica_1565523667_357865.html.txt
196,0,0,soltura-lula,elpais,0,0,0,0,0,0,0,0,brasil.elpais.com___brasil_2019_09_26_politica_1569512822_274743.html.txt
197,-2,9,soltura-lula,elpais,489,8,17,4,397,36,34,51,brasil.elpais.com___brasil_2019_09_27_politica_1569619461_962971.html.txt
198,-2,-1,soltura-lula,elpais,261,10,9,1,234,16,14,17,brasil.elpais.com___brasil_2019_09_27_politica_1569621516_273670.html.txt
199,5,-14,soltura-lula,elpais,736,28,14,4,596,43,48,95,brasil.elpais.com___brasil_2019_10_16_politica_1571260989_750853.html.txt
200,17,0,soltura-lula,elpais,617,22,22,6,493,39,56,79,brasil.elpais.com___brasil_2019_10_17_politica_1571324948_116990.html.txt
201,6,6,reforma-previdencia,elpais,474,4,10,3,382,17,23,69,brasil.elpais.com___brasil_2019_10_22_politica_1571772353_347004.html.txt
202,18,6,reforma-previdencia,elpais,731,7,13,2,567,27,45,114,brasil.elpais.com___brasil_2019_10_23_politica_1571785420_079177.html.txt
203,6,-1,soltura-lula,elpais,427,7,6,4,360,21,27,36,brasil.elpais.com___brasil_2019_10_24_politica_1571935645_993613.html.txt
204,1,4,soltura-lula,elpais,459,18,22,3,397,29,30,46,brasil.elpais.com___brasil_2019_10_31_politica_1572533924_138228.html.txt
205,2,-2,soltura-lula,elpais,463,21,19,4,396,33,35,43,brasil.elpais.com___brasil_2019_11_07_politica_1573137631_054672.html.txt
206,4,4,soltura-lula,elpais,416,16,20,5,348,21,25,63,brasil.elpais.com___brasil_2019_11_08_internacional_1573251966_050357.html.txt
207,-4,-8,soltura-lula,elpais,85,9,1,1,85,6,2,3,brasil.elpais.com___brasil_2019_11_08_politica_1573230948_757857.html.txt
208,0,-14,soltura-lula,elpais,376,22,8,6,296,37,37,42,brasil.elpais.com___brasil_2019_11_08_politica_1573233784_149921.html.txt
209,10,0,soltura-lula,elpais,238,9,9,2,199,8,18,33,brasil.elpais.com___brasil_2019_11_08_politica_1573243603_302199.html.txt
210,5,-7,soltura-lula,elpais,248,13,6,0,225,11,16,15,brasil.elpais.com___brasil_2019_11_08_politica_1573246435_115485.html.txt
211,10,1,soltura-lula,elpais,628,11,12,4,500,28,38,89,brasil.elpais.com___brasil_2019_11_09_politica_1573254096_185855.html.txt
212,0,1,soltura-lula,elpais,526,15,16,8,419,35,35,76,brasil.elpais.com___brasil_2019_11_09_politica_1573262549_557712.html.txt
213,-2,0,soltura-lula,elpais,108,5,5,1,95,6,4,14,brasil.elpais.com___brasil_2019_11_09_politica_1573305490_484630.html.txt
214,4,9,soltura-lula,elpais,826,26,35,8,644,45,49,157,brasil.elpais.com___brasil_2019_11_09_politica_1573337968_481157.html.txt
215,7,0,soltura-lula,elpais,867,22,22,4,737,39,46,93,brasil.elpais.com___brasil_2019_11_12_politica_1573557270_097382.html.txt
216,-1,-8,soltura-lula,elpais,570,22,14,4,468,32,31,79,brasil.elpais.com___brasil_2019_11_28_politica_1574939740_491523.html.txt
217,33,12,reforma-trabalhista,estadao,237,0,12,0,170,6,39,34,economia.estadao.com.br___blogs_o-seguro-morreu-de-velho_o-papel-dos-sindicatos-apos-a-reforma-trabalhista_.txt
218,14,4,reforma-previdencia,estadao,222,0,4,2,173,6,20,29,economia.estadao.com.br___blogs_o-seguro-morreu-de-velho_reforma-da-previdencia-e-as-novas-regras-para-aposentadoria-especial_.txt
219,2,0,reforma-trabalhista,estadao,24,1,1,0,22,0,2,2,"economia.estadao.com.br___galerias_geral,veja-as-5-profissoes-mais-afetadas-pela-reforma-trabalhista,35019.txt"
220,30,0,reforma-previdencia,estadao,544,4,4,2,421,13,43,77,"economia.estadao.com.br___noticias_geral,180-deputados-estao-dispostos-a-aprovar-reforma-da-previdencia-mas-com-ajustes,70002762940.txt"
221,0,1,reforma-trabalhista,estadao,334,7,8,0,273,20,20,36,"economia.estadao.com.br___noticias_geral,a-caixa-preta-do-sistema-s,70001779709.txt"
222,8,0,reforma-trabalhista,estadao,289,6,6,4,234,12,20,39,"economia.estadao.com.br___noticias_geral,a-polarizacao-de-volta-nas-redes-sociais,70001753622.txt"
223,2,2,reforma-previdencia,estadao,167,1,3,0,144,4,6,17,"economia.estadao.com.br___noticias_geral,aliquota-para-servidor-pode-chegar-a-ate-22-depois-de-reforma-da-previdencia,70002729112.txt"
224,25,2,reforma-previdencia,estadao,1061,11,13,6,852,19,44,176,"economia.estadao.com.br___noticias_geral,apesar-de-crise-em-articulacao-politica-apoio-a-reforma-cresce-na-camara,70002782213.txt"
225,10,-8,reforma-trabalhista,estadao,338,8,0,0,244,18,28,56,"economia.estadao.com.br___noticias_geral,apos-reforma-trabalhista-sindicatos-demitem-para-sobreviver,70002097236.txt"
226,0,-2,reforma-trabalhista,estadao,218,4,2,2,167,12,12,35,"economia.estadao.com.br___noticias_geral,apos-se-posicionar-contra-reformas-psb-muda-orientacao-e-libera-bancada,70001751338.txt"
227,28,2,reforma-previdencia,estadao,507,11,13,2,416,14,42,61,"economia.estadao.com.br___noticias_geral,bolsa-avanca-acima-dos-103-mil-pontos-com-abertura-de-sessao-da-previdencia,70002904593.txt"
228,3,-4,reforma-previdencia,estadao,216,6,2,0,167,13,16,28,"economia.estadao.com.br___noticias_geral,bolsonaro-admite-que-capitalizacao-pode-ficar-de-fora-da-reforma-da-previdencia,70002780520.txt"
229,-1,1,reforma-previdencia,estadao,584,8,9,2,466,26,25,86,"economia.estadao.com.br___noticias_geral,camara-rejeita-mudancas-no-texto-da-previdencia,70002959155.txt"
230,9,-3,reforma-trabalhista,estadao,284,4,1,1,228,4,13,45,"economia.estadao.com.br___noticias_geral,centrais-sindicais-preparam-greve-geral-para-o-proximo-dia-28,70001747437.txt"
231,8,-2,reforma-trabalhista,estadao,274,5,3,4,208,14,22,42,"economia.estadao.com.br___noticias_geral,com-a-reforma-trabalhista-talvez-a-gente-nao-precise-de-5-mil-juizes-do-trabalho-diz-maia,70002090941.txt"
232,10,6,reforma-trabalhista,estadao,246,1,7,0,203,10,20,21,"economia.estadao.com.br___noticias_geral,com-nova-lei-hospital-de-sp-elimina-folga-para-quem-trabalhar-no-feriado,70002079921.txt"
233,11,1,reforma-trabalhista,estadao,260,4,5,4,196,9,20,48,"economia.estadao.com.br___noticias_geral,com-nova-lei-trabalhador-intermitente-pode-ficar-sem-beneficios-do-inss,70002085933.txt"
234,0,4,reforma-previdencia,estadao,561,6,10,7,446,26,26,86,"economia.estadao.com.br___noticias_geral,com-novas-mudancas-de-relator-economia-de-reforma-da-previdencia-cai-para-r-870-bi-em-dez-anos,70002996227.txt"
235,22,1,reforma-trabalhista,estadao,336,3,4,2,256,11,33,45,"economia.estadao.com.br___noticias_geral,com-regra-de-trabalho-intermitente-empregado-corre-risco-de-ter-de-pagar-para-trabalhar,70002099195.txt"
236,21,4,reforma-previdencia,estadao,1040,12,16,4,866,31,52,123,"economia.estadao.com.br___noticias_geral,como-fica-minha-aposentadoria-com-a-proposta-da-previdencia-aprovada-no-senado,70003032903.txt"
237,0,3,reforma-previdencia,estadao,318,1,4,0,230,21,21,51,"economia.estadao.com.br___noticias_geral,deputados-vao-apresentar-novo-projeto-para-reforma-da-previdencia,70002833319.txt"
238,2,-1,reforma-trabalhista,estadao,160,4,3,0,131,8,10,18,"economia.estadao.com.br___noticias_geral,derrota-na-cas-significa-que-governo-nao-conseguiu-articular-senadores-diz-relator,70001851120.txt"
239,3,0,reforma-previdencia,estadao,265,3,3,1,219,10,13,30,"economia.estadao.com.br___noticias_geral,dolar-cai-com-otimismo-sobre-reforma-da-previdencia,70002877144.txt"
240,6,1,soltura-lula,estadao,185,4,5,2,143,7,13,33,"economia.estadao.com.br___noticias_geral,dolar-sobe-apos-decisao-do-stf-que-pode-beneficiar-lula,70003081471.txt"
241,7,-1,reforma-trabalhista,estadao,213,5,4,1,184,8,15,16,"economia.estadao.com.br___noticias_geral,em-comissao-e-adiada-mas-deve-ir-a-plenario-este-mes,70001831351.txt"
242,2,-1,reforma-previdencia,estadao,199,1,0,1,145,12,14,30,"economia.estadao.com.br___noticias_geral,em-jerusalem-bolsonaro-acredita-em-reforma-ate-junho-sem-muita-desidratacao,70002775707.txt"
243,23,1,reforma-previdencia,estadao,322,7,8,1,256,9,32,41,"economia.estadao.com.br___noticias_geral,empresarios-se-mobilizam-para-proteger-reforma,70002771971.txt"
244,6,9,reforma-trabalhista,estadao,349,0,9,5,284,14,20,45,"economia.estadao.com.br___noticias_geral,entenda-as-principais-mudancas-propostas-pela-reforma-trabalhista,70001751786.txt"
245,15,11,reforma-previdencia,estadao,730,8,19,7,592,30,45,97,"economia.estadao.com.br___noticias_geral,entenda-os-principais-pontos-do-relatorio-da-previdencia-aprovado-na-comissao-especial,70002905649.txt"
246,11,7,reforma-trabalhista,estadao,308,2,9,4,250,14,25,34,"economia.estadao.com.br___noticias_geral,feriado-em-dia-util-agora-pode-ser-transferido-ate-para-sabado,70002079997.txt"
247,16,5,reforma-previdencia,estadao,348,1,6,1,287,10,26,33,"economia.estadao.com.br___noticias_geral,governo-recua-na-reta-final-e-senado-conclui-reforma-da-previdencia,70003060782.txt"
248,2,1,reforma-previdencia,estadao,152,3,4,0,123,8,10,18,"economia.estadao.com.br___noticias_geral,guedes-diz-que-renuncia-se-reforma-da-previdencia-virar-reforminha,70002841889.txt"
249,8,-5,reforma-trabalhista,estadao,316,9,4,3,257,14,22,39,"economia.estadao.com.br___noticias_geral,hoje-vende-se-peixe-fresco,70001755282.txt"
250,0,3,reforma-previdencia,estadao,358,5,8,1,307,14,14,37,"economia.estadao.com.br___noticias_geral,impacto-da-reforma-e-de-r-860-bilhoes-so-com-cortes-diz-paulo-guedes,70002872552.txt"
251,11,-5,reforma-previdencia,estadao,300,11,6,2,228,13,24,54,"economia.estadao.com.br___noticias_geral,maia-ameaca-deixar-articulacao-politica-da-previdencia,70002764319.txt"
252,-3,-1,reforma-trabalhista,estadao,281,2,1,0,222,18,15,29,"economia.estadao.com.br___noticias_geral,membros-da-comissao-de-reforma-tem-debitos-trabalhistas,70001739113.txt"
253,44,24,reforma-trabalhista,estadao,591,9,33,3,440,28,72,96,"economia.estadao.com.br___noticias_geral,novas-regras-da-clt-valorizam-a-justica-do-trabalho-afirma-especialista,70002084456.txt"
254,2,4,reforma-previdencia,estadao,478,6,10,0,388,20,22,64,"economia.estadao.com.br___noticias_geral,o-que-muda-no-novo-texto-de-reforma-da-previdencia,70002900500.txt"
255,41,18,reforma-previdencia,estadao,1812,34,52,11,1387,105,146,271,"economia.estadao.com.br___noticias_geral,os-politicos-tem-de-controlar-100-do-orcamento,70002749472.txt"
256,11,2,reforma-trabalhista,estadao,259,5,7,2,194,13,24,42,"economia.estadao.com.br___noticias_geral,para-empresarios-nova-lei-moderniza-relacoes-de-trabalho,70001886413.txt"
257,-9,-6,reforma-previdencia,estadao,229,10,4,4,200,20,11,16,"economia.estadao.com.br___noticias_geral,pdt-ameaca-expulsar-tabata-amaral-caso-vote-a-favor-da-reforma-da-previdencia,70002914754.txt"
258,2,-1,reforma-previdencia,estadao,265,4,3,0,208,12,14,38,"economia.estadao.com.br___noticias_geral,placar-da-previdencia-ja-conta-com-42-dos-49-votos-para-aprovacao-no-senado,70002921963.txt"
259,10,3,reforma-trabalhista,estadao,274,7,10,1,223,14,24,31,"economia.estadao.com.br___noticias_geral,quarentena-evita-corte-em-massa-e-recontratacao,70002088771.txt"
260,15,1,reforma-trabalhista,estadao,315,5,6,2,246,17,32,33,"economia.estadao.com.br___noticias_geral,quem-perde-com-a-reforma-trabalhista,70002062233.txt"
261,12,1,reforma-previdencia,estadao,560,11,12,4,452,25,37,73,"economia.estadao.com.br___noticias_geral,reforma-da-previdencia-e-aprovada-na-ccj-por-48-votos-a-favor-e-18-contra,70002801858.txt"
262,7,5,reforma-previdencia,estadao,310,3,8,4,250,13,20,42,"economia.estadao.com.br___noticias_geral,reforma-da-previdencia-ja-tem-os-votos-necessarios-para-ser-aprovada-no-senado,70002962820.txt"
263,15,2,reforma-trabalhista,estadao,326,2,4,6,254,8,23,53,"economia.estadao.com.br___noticias_geral,reforma-da-previdencia-nao-poe-fim-a-privilegios-de-algumas-categorias,70001740783.txt"
264,25,2,reforma-previdencia,estadao,1061,11,13,6,852,19,44,176,"economia.estadao.com.br___noticias_geral,reforma-da-previdencia-veja-o-que-muda-na-sua-aposentadoria,70002730702.txt"
265,5,1,reforma-previdencia,estadao,240,1,2,0,193,6,11,33,"economia.estadao.com.br___noticias_geral,reforma-da-previdencia-veja-propostas-do-governo-bolsonaro,70002707364.txt"
266,8,5,reforma-trabalhista,estadao,231,2,7,0,183,10,18,29,"economia.estadao.com.br___noticias_geral,reforma-rabalhista-acaba-com-homologacao-na-rescisao-tema-de-30-dos-processos-na-justica,70001777702.txt"
267,10,9,reforma-trabalhista,estadao,168,0,9,2,134,4,14,27,"economia.estadao.com.br___noticias_geral,reforma-trabalhista-preve-que-ferias-possam-ser-determinadas-pelo-empregador,70001751524.txt"
268,0,6,reforma-trabalhista,estadao,243,0,6,3,205,12,12,23,"economia.estadao.com.br___noticias_geral,reforma-trabalhista-senador-propoe-acabar-com-repasse-ao-sistema-s,70001765381.txt"
269,16,14,reforma-trabalhista,estadao,365,6,20,3,267,24,40,63,"economia.estadao.com.br___noticias_geral,reforma-trabalhista-so-afetara-novos-contratos-de-trabalho,70001887523.txt"
270,22,6,reforma-trabalhista,estadao,296,3,9,1,213,13,35,48,"economia.estadao.com.br___noticias_geral,reforma-trabalhista-viola-convencoes-internacionais-diz-oit,70001884924.txt"
271,-3,4,reforma-trabalhista,estadao,171,4,8,3,137,13,10,26,"economia.estadao.com.br___noticias_geral,reforma-vai-tirar-direitos-afirma-ministro-do-tst,70001775411.txt"
272,1,-20,reforma-trabalhista,estadao,664,36,16,3,541,42,43,93,"economia.estadao.com.br___noticias_geral,retomada-da-confianca-na-economia-foi-a-aposta-do-primeiro-ano-de-temer,70001775167.txt"
273,4,-1,reforma-previdencia,estadao,110,2,1,0,86,3,7,17,"economia.estadao.com.br___noticias_geral,senado-adia-votacao-da-reforma-da-previdencia-em-uma-semana,70002969253.txt"
274,17,9,reforma-previdencia,estadao,588,5,14,2,476,25,42,66,"economia.estadao.com.br___noticias_geral,senado-aprova-pec-paralela-que-inclui-estados-e-municipios-na-reforma-da-previdencia,70003078873.txt"
275,16,7,reforma-trabalhista,estadao,447,5,12,0,360,20,36,48,"economia.estadao.com.br___noticias_geral,senado-aprova-reforma-trabalhista,70001886124.txt"
276,0,-18,reforma-trabalhista,estadao,368,20,2,2,296,26,26,44,"economia.estadao.com.br___noticias_geral,senadores-batem-boca-quase-se-agridem-em-sessao-sobre-reforma-trabalhista,70001809109.txt"
277,-2,1,reforma-previdencia,estadao,328,3,4,1,267,18,16,35,"economia.estadao.com.br___noticias_geral,servidores-publicos-querem-barrar-reforma-da-previdencia-na-ccj,70002776083.txt"
278,16,7,reforma-previdencia,estadao,231,2,9,1,182,6,22,33,"economia.estadao.com.br___noticias_geral,sou-favoravel-a-reforma-da-previdencia-com-alguns-ajustes-diz-presidente-da-comissao-especial,70002805225.txt"
279,6,5,impeachment-dilma,estadao,457,12,17,4,365,30,36,59,"economia.estadao.com.br___noticias_geral,suspensao-do-brasil-do-mercosul-em-caso-de-impeachment-pode-ser-estudada--diz-chanceler-argentina,10000022460.txt"
280,13,4,reforma-trabalhista,estadao,245,3,7,1,181,13,26,36,"economia.estadao.com.br___noticias_geral,temer-sanciona-terceirizacao-com-vetos,70001722268.txt"
281,7,4,reforma-trabalhista,estadao,193,4,8,0,167,4,11,23,"economia.estadao.com.br___noticias_geral,trabalhador-e-condenado-apos-conduta-em-processo-ser-considerada-ma-fe,70002082851.txt"
282,20,12,reforma-previdencia,estadao,770,7,19,8,615,34,54,101,"economia.estadao.com.br___noticias_geral,veja-a-proposta-de-reforma-da-previdencia-que-os-deputados-votam-hoje,70002915751.txt"
283,-3,5,reforma-previdencia,estadao,653,3,8,5,550,26,23,70,"economia.estadao.com.br___noticias_geral,veja-as-diferencas-entre-o-texto-da-reforma-da-previdencia-da-camara-e-do-senado,70002984997.txt"
284,38,16,reforma-trabalhista,estadao,544,7,23,3,428,15,53,81,"educacao.estadao.com.br___noticias_geral,reforma-trabalhista-ja-afeta-a-faculdade,70001936390.txt"
285,22,-3,reforma-previdencia,epoca,542,15,12,4,420,30,52,71,epoca.globo.com___a-reforma-nao-pode-nao-deve-ser-mais-adiada-diz-nelson-barbosa-23687128.txt
286,4,-3,soltura-lula,epoca,368,10,7,3,305,11,15,57,epoca.globo.com___a-repercussao-internacional-da-libertacao-do-ex-presidente-lula-24071576.txt
287,12,1,reforma-previdencia,epoca,464,6,7,4,369,27,39,46,epoca.globo.com___agosto-a-data-limite-para-aprovar-reforma-da-previdencia-23700025.txt
288,9,2,reforma-previdencia,epoca,266,5,7,1,205,13,22,39,epoca.globo.com___brasil_abstencao-de-frota-em-votacao-da-previdencia-foi-recado-para-governo-23859976.txt
289,3,-1,soltura-lula,epoca,90,3,2,2,72,3,6,16,epoca.globo.com___brasil_lula-diz-querer-bernie-sanders-como-presidente-dos-eua-24071562.txt
290,8,-2,soltura-lula,epoca,324,6,4,1,251,13,21,50,epoca.globo.com___brasil_lula-ganhou-mais-de-260-mil-seguidores-no-twitter-ao-sair-da-prisao-24103564.txt
291,7,-1,soltura-lula,epoca,646,21,20,6,549,32,39,73,epoca.globo.com___brasil_nao-se-assustem-se-alguem-pedir-ai-5-diz-guedes-sobre-lula-chamar-povo-pra-rua-24100827.txt
292,2,-1,soltura-lula,epoca,49,2,1,0,40,3,5,4,epoca.globo.com___brasil_os-planos-de-lula-ex-presidente-quer-viajar-pelo-brasil-reorganizar-oposicao-ao-governo-24069866.txt
293,3,4,reforma-previdencia,epoca,419,6,10,0,342,13,16,64,epoca.globo.com___brasil_reforma-da-previdencia-aprovada-sob-pressao-ultimatos-de-maia-23798316.txt
294,-4,0,soltura-lula,epoca,95,3,3,1,73,9,5,15,epoca.globo.com___brasil_soltura-de-lula-causara-uniao-em-torno-do-antipetismo-diz-eduardo-bolsonaro-24072435.txt
295,10,-13,reforma-previdencia,epoca,239,17,4,3,175,23,33,32,epoca.globo.com___brasil_tabata-esta-sendo-tratada-de-forma-imoral-por-pdt-diz-felipe-rigoni-23811665.txt
296,-9,-2,soltura-lula,epoca,507,14,12,1,428,35,26,45,epoca.globo.com___brasil_vazamento-de-dialogos-mortes-na-familia-entrevistas-que-aconteceu-com-lula-durante-tempo-na-prisao-24072124.txt
297,4,7,impeachment-dilma,epoca,229,0,7,0,176,14,18,28,epoca.globo.com___colunas-e-blogs_blog-do-fucs_noticia_2015_12_fachin-o-impeachment-e-goleada-da-oposicao-no-stf.html.txt
298,13,0,reforma-previdencia,epoca,276,3,3,5,230,6,19,32,epoca.globo.com___dois-tercos-dos-brasileiros-acham-reforma-da-previdencia-necessaria-segundo-pesquisa-23656847.txt
299,9,0,reforma-trabalhista,epoca,390,6,6,0,302,14,23,63,epoca.globo.com___economia_noticia_2017_03_terceirizacao-cria-bons-empregos.html.txt
300,14,6,reforma-trabalhista,epoca,662,12,18,5,518,32,46,101,epoca.globo.com___economia_noticia_2017_04_reforma-trabalhista-moderniza-lei-e-facilita-criar-empregos-mas-deixa-lacuna.html.txt
301,-25,-17,reforma-trabalhista,epoca,512,30,13,6,391,57,32,81,epoca.globo.com___economia_noticia_2017_04_reformas-propostas-por-temer-prejudicam-os-pobres-nao.html.txt
302,29,-7,reforma-trabalhista,epoca,1093,26,19,5,872,62,91,118,epoca.globo.com___economia_noticia_2017_11_reforma-trabalhista-entra-em-vigor-os-envolvidos-preparam-se-para-uma-batalha.html.txt
303,-4,-8,reforma-previdencia,epoca,1988,50,42,16,1564,125,121,286,epoca.globo.com___economia_os-proximos-passos-da-agenda-de-paulo-guedes-23782828.txt
304,-4,-3,prisao-lula,epoca,36,4,1,0,35,4,0,2,epoca.globo.com___expresso_pt-compara-lula-mandela-22898699.txt
305,0,0,soltura-lula,epoca,78,2,2,1,58,4,4,17,epoca.globo.com___fas-da-corrupcao-socialista-em-todo-mundo-estao-comemorando-libertacao-de-lula-diz-ernesto-araujo-24073181.txt
306,6,0,reforma-previdencia,epoca,117,1,1,1,100,4,10,6,epoca.globo.com___governadores-de-sete-estados-anunciam-apoio-reforma-da-previdencia-23627081.txt
307,-4,0,soltura-lula,epoca,115,3,3,0,99,9,5,8,epoca.globo.com___guilherme-amado_advogado-se-reunira-de-manha-com-lula-para-discutir-soltura-1-24068992.txt
308,4,-3,soltura-lula,epoca,107,6,3,1,87,5,9,16,epoca.globo.com___guilherme-amado_eduardo-bolsonaro-culpadecisao-do-stf-soltura-de-lula-por-alta-do-dolar-1-24108998.txt
309,1,-1,soltura-lula,epoca,106,5,4,0,84,7,8,16,epoca.globo.com___guilherme-amado_em-artigo-no-washington-post-lula-ataca-bolsonaro-moro-24092666.txt
310,35,-13,soltura-lula,epoca,985,64,51,6,736,91,126,153,epoca.globo.com___guilherme-amado_fhc-torce-por-lula-conciliador-afirma-estar-disposto-ao-dialogo-1-24083245.txt
311,7,-5,soltura-lula,epoca,552,23,18,8,449,37,44,71,epoca.globo.com___guilherme-amado_lula-a-agua-no-chope-da-terceira-via-24082838.txt
312,-4,-2,soltura-lula,epoca,59,3,1,0,52,5,1,5,epoca.globo.com___guilherme-amado_lula-encontrara-viuva-de-eduardo-campos-hoje-24085447.txt
313,0,-3,soltura-lula,epoca,65,3,0,0,55,4,4,5,epoca.globo.com___guilherme-amado_primeiros-beneficiados-por-fim-da-prisao-em-segunda-instancia-foram-criminosos-do-colarinho-branco-24071935.txt
314,-3,-10,soltura-lula,epoca,598,25,15,3,479,45,42,75,epoca.globo.com___inelegivel-lula-sera-megafone-da-oposicao-bolsonaro-dizem-petistas-24073197.txt
315,1,0,reforma-previdencia,epoca,84,1,1,0,72,3,4,7,epoca.globo.com___merchandising-da-previdencia-no-programa-do-ratinho-custou-268-mil-23715140.txt
316,21,3,reforma-previdencia,epoca,438,10,13,2,370,17,38,38,epoca.globo.com___novos-episodios-na-briga-entre-moro-maia-ameacam-ate-reforma-da-previdencia-23542859.txt
317,5,7,reforma-previdencia,epoca,419,2,9,2,324,23,28,57,epoca.globo.com___o-que-ja-mudou-o-que-ainda-deve-mudar-na-reforma-da-previdencia-23617963.txt
318,2,-1,reforma-trabalhista,epoca,98,2,1,0,73,5,7,16,epoca.globo.com___politica_expresso_noticia_2017_04_presidentes-das-centrais-sindicais-comemoram-uniao-na-greve.html.txt
319,0,0,afastamento-aecio,epoca,0,0,0,0,0,0,0,0,epoca.globo.com___politica_expresso_noticia_2017_06_joesley-batista-estava-desesperado-quando-obteve-delacao.html.txt
320,1,-1,afastamento-aecio,epoca,48,2,1,1,41,2,3,6,epoca.globo.com___politica_expresso_noticia_2017_07_novo-presidente-da-juventude-do-psdb-e-alinhado-com-aecio-neves.html.txt
321,-1,-3,afastamento-aecio,epoca,88,5,2,1,76,5,4,11,epoca.globo.com___politica_expresso_noticia_2017_07_reencontro-de-aecio-neves-e-randolfe-rodrigues-no-senado-causa-expectativa.html.txt
322,4,3,afastamento-aecio,epoca,108,3,6,1,86,10,14,8,epoca.globo.com___politica_expresso_noticia_2017_10_aecio-neves-envia-carta-senadores-em-que-pede-apoio-para-permanecer-no-cargo.html.txt
323,1,1,prisao-lula,epoca,48,0,1,0,42,2,3,2,epoca.globo.com___politica_expresso_noticia_2018_03_advogado-de-lula-dispensa-ajuda-de-terceiros-interessados-em-livrar-o-ex-presidente-da-prisao.html.txt
324,-1,0,prisao-lula,epoca,94,2,2,1,84,5,4,6,epoca.globo.com___politica_expresso_noticia_2018_03_defesa-afirma-que-o-habeas-corpus-de-palocci-e-mais-urgente-que-o-de-lula.html.txt
325,0,-1,prisao-lula,epoca,55,1,0,1,48,2,2,5,epoca.globo.com___politica_expresso_noticia_2018_04_gritos-de-lula-ladrao-e-deixa-ele-em-paz-sao-ouvidos-em-frente-ao-predio-do-ex-presidente.html.txt
326,-3,-2,prisao-lula,epoca,60,2,0,1,49,5,2,7,epoca.globo.com___politica_expresso_noticia_2018_04_moro-fica-aliviado-com-o-desfecho-sem-violencia-da-prisao-de-lula.html.txt
327,1,-1,prisao-lula,epoca,69,2,1,1,63,2,3,5,epoca.globo.com___politica_expresso_noticia_2018_04_policia-federal-pode-acionar-dois-grupos-especiais-caso-lula-nao-se-entregue.html.txt
328,4,0,prisao-lula,epoca,67,1,1,0,52,4,8,5,epoca.globo.com___politica_expresso_noticia_2018_04_por-que-felix-fischer-negou-habeas-corpus-lula.html.txt
329,0,1,prisao-lula,epoca,90,3,4,1,83,5,5,5,epoca.globo.com___politica_expresso_noticia_2018_04_tribunal-afirma-que-defesa-de-lula-nao-deveria-querer-reabrir-materia-superada.html.txt
330,0,-5,afastamento-aecio,epoca,598,18,13,2,481,47,47,56,epoca.globo.com___politica_lava-jato_noticia_2017_05_provas-que-complicam-vida-de-aecio-neves.html.txt
331,6,-5,afastamento-aecio,epoca,262,8,3,3,216,13,19,28,epoca.globo.com___politica_noticia_2017_05_acoes-controladas-nova-arma-da-lava-jato-que-enquadrou-temer-e-aecio.html.txt
332,-5,-14,afastamento-aecio,epoca,763,29,15,4,617,66,61,67,epoca.globo.com___politica_noticia_2017_05_aecio-neves-afastado-do-senado-e-ficou-barato.html.txt
333,7,2,reforma-trabalhista,epoca,212,3,5,0,156,11,18,35,epoca.globo.com___politica_noticia_2017_05_nossa-opiniao-reforma-trabalhista-e-seus-pontos-fracos.html.txt
334,17,-3,reforma-trabalhista,epoca,443,10,7,3,358,15,32,58,epoca.globo.com___politica_noticia_2017_07_reforma-trabalhista-e-do-pais-e-nao-de-temer-na-visao-que-avanca-no-congresso.html.txt
335,-23,-5,afastamento-aecio,epoca,997,18,13,3,807,81,58,85,epoca.globo.com___politica_noticia_2017_08_exclusivo-malas-de-dinheiro-da-jbs-destinadas-temer-e-aecio.html.txt
336,12,4,afastamento-aecio,epoca,366,13,17,4,300,23,35,42,epoca.globo.com___politica_noticia_2017_10_nao-e-apenas-por-aecio-neves.html.txt
337,-7,-34,prisao-lula,epoca,1119,59,25,12,929,81,74,131,epoca.globo.com___politica_noticia_2018_03_o-pt-nas-maos-da-presidente-em-caso-de-prisao-de-lula.html.txt
338,-2,-16,prisao-lula,epoca,964,35,19,9,812,52,50,113,epoca.globo.com___politica_noticia_2018_04_como-rendicao-de-lula-foi-negociada.html.txt
339,-2,1,prisao-lula,epoca,562,26,27,7,443,49,47,83,epoca.globo.com___politica_noticia_2018_04_lula-soltou-o-monstro-do-odio.html.txt
340,2,-5,prisao-lula,epoca,552,20,15,9,449,41,43,63,epoca.globo.com___politica_noticia_2018_04_o-habeas-corpus-de-lula-no-stf-e-batalha-pela-narrativa-digital.html.txt
341,3,-1,prisao-lula,epoca,253,7,6,6,212,16,19,25,epoca.globo.com___politica_noticia_2018_04_o-que-iminente-prisao-de-lula-provoca-no-cenario-eleitoral.html.txt
342,-1,-7,prisao-lula,epoca,248,9,2,5,220,9,8,27,epoca.globo.com___politica_noticia_2018_04_por-lula-e-por-si-mesmo.html.txt
343,-11,-16,prisao-lula,epoca,1008,38,22,8,831,72,61,112,epoca.globo.com___politica_noticia_2018_07_trombadas-e-ciumes-advogados-de-lula-divergem-em-relacao-estrategia-de-defesa-do-petista.html.txt
344,32,10,reforma-previdencia,epoca,471,6,16,2,358,18,50,69,epoca.globo.com___reforma-da-previdencia-ambiciosa-diz-economista-chefe-do-itau-23467954.txt
345,0,-2,reforma-previdencia,epoca,292,7,5,2,239,15,15,37,epoca.globo.com___sem-guedes-aprovacao-da-reforma-da-previdencia-so-aconteceria-em-2020-diz-economista-23555544.txt
346,20,-3,reforma-trabalhista,epoca,383,13,10,3,278,29,49,53,epoca.globo.com___sociedade_ruth-de-aquino_noticia_2017_04_o-direito-de-parar-e-o-direito-de-trabalhar.html.txt
347,5,-1,impeachment-dilma,epoca,107,5,4,0,88,6,11,11,epoca.globo.com___tempo_especial-impeachment_noticia_2016_04_lula-temer-sabe-que-estao-fazendo-golpe.html.txt
348,-5,-7,impeachment-dilma,epoca,338,14,7,1,279,25,20,36,epoca.globo.com___tempo_especial-impeachment_noticia_2016_04_pedaladas-sao-motivo-suficiente-para-o-impeachment-nao.html.txt
349,-10,-1,impeachment-dilma,epoca,278,5,4,2,213,22,12,42,epoca.globo.com___tempo_especial-impeachment_noticia_2016_08_o-ultimo-toma-la-da-ca-de-dilma.html.txt
350,-19,-9,impeachment-dilma,epoca,646,17,8,5,525,49,30,72,epoca.globo.com___tempo_especial-impeachment_noticia_2016_08_pedaladas-verbais-de-dilma-no-senado.html.txt
351,16,-3,impeachment-dilma,epoca,885,24,21,7,743,44,60,90,epoca.globo.com___tempo_especial-impeachment_noticia_2016_09_como-foi-costurado-o-acordao-para-salvar-os-alvos-da-lava-jato.html.txt
352,5,-6,impeachment-dilma,epoca,157,8,2,2,135,8,13,13,epoca.globo.com___tempo_expresso_noticia_2016_03_advogados-petistas-classificam-pedido-de-impeachment-da-oab-como-parcial.html.txt
353,3,-1,impeachment-dilma,epoca,92,1,0,1,80,1,4,9,epoca.globo.com___tempo_expresso_noticia_2016_04_depois-de-orar-com-dilma-deputado-decide-votar-contra-impeachment.html.txt
354,-2,-1,impeachment-dilma,epoca,67,1,0,2,54,4,2,10,epoca.globo.com___tempo_expresso_noticia_2016_04_petistas-ja-nao-querem-que-stf-autorize-lula-virar-ministro-da-casa-civil.html.txt
355,-1,1,impeachment-dilma,epoca,61,1,2,2,47,5,4,10,epoca.globo.com___tempo_expresso_noticia_2016_04_secretario-de-governador-do-pt-trai-chefe-e-vota-pelo-impeachment.html.txt
356,7,0,impeachment-dilma,epoca,60,2,2,1,52,1,8,4,epoca.globo.com___tempo_expresso_noticia_2016_04_senador-indicado-para-presidir-impeachment-e-suplente-e-um-dos-mais-ricos-do-congresso.html.txt
357,2,2,impeachment-dilma,epoca,142,0,2,0,99,11,13,21,epoca.globo.com___tempo_noticia_2015_12_como-funciona-o-processo-de-impeachment-de-dilma.html.txt
358,13,8,impeachment-dilma,epoca,281,0,8,0,230,11,24,24,epoca.globo.com___tempo_noticia_2015_12_diferencas-entre-processos-de-impeachment-de-fernando-collor-e-dilma-rousseff.html.txt
359,5,0,impeachment-dilma,epoca,311,8,8,2,264,13,18,34,epoca.globo.com___tempo_noticia_2015_12_em-sao-paulo-protesto-comeca-com-musica-classica.html.txt
360,11,-5,impeachment-dilma,epoca,250,10,5,0,220,4,15,26,epoca.globo.com___tempo_noticia_2015_12_manifestantes-saem-ruas-em-protesto-neste-domingo.html.txt
361,7,13,impeachment-dilma,epoca,420,2,15,2,343,24,31,41,epoca.globo.com___tempo_noticia_2015_12_o-que-diz-o-pedido-de-helio-bicudo-para-o-impeachment-da-presidente-dilma-rousseff.html.txt
362,5,2,impeachment-dilma,epoca,63,0,2,0,55,0,5,5,epoca.globo.com___tempo_noticia_2015_12_prefeitos-de-14-cidades-assinam-carta-em-repudio-impeachment-de-dilma.html.txt
363,11,0,impeachment-dilma,epoca,255,6,6,1,211,10,21,26,epoca.globo.com___tempo_noticia_2015_12_tucanos-discursam-no-carro-de-som-do-vem-pra-rua.html.txt
364,10,7,impeachment-dilma,epoca,969,11,18,2,829,30,40,101,epoca.globo.com___tempo_noticia_2016_03_audios-complicam-dilma-e-lula-acompanhe.html.txt
365,21,-28,impeachment-dilma,epoca,1929,51,23,6,1666,68,89,186,epoca.globo.com___tempo_noticia_2016_03_manifestacoes-de-13-de-marco-em-todo-o-brasil-acompanhe.html.txt
366,10,0,impeachment-dilma,epoca,228,6,6,3,180,10,20,33,epoca.globo.com___tempo_noticia_2016_03_pmdb-considera-impeachment-de-dilma-inevitavel.html.txt
367,6,2,impeachment-dilma,epoca,202,1,3,0,183,3,9,11,epoca.globo.com___tempo_noticia_2016_04_comissao-aprova-processo-de-impeachment-de-dilma.html.txt
368,-7,-2,impeachment-dilma,epoca,131,2,0,4,106,15,8,8,epoca.globo.com___tempo_noticia_2016_04_dilma-exonera-quatro-ministros-para-votar-contra-o-impeachment.html.txt
369,-8,2,impeachment-dilma,epoca,241,4,6,2,191,16,8,38,epoca.globo.com___tempo_noticia_2016_04_dilma-usa-discurso-na-onu-para-falar-de-grave-momento-que-vive-o-brasil.html.txt
370,-21,-10,impeachment-dilma,epoca,650,22,12,10,519,48,27,100,epoca.globo.com___tempo_noticia_2016_04_lula-briga-ate-o-ultimo-minuto-em-vao-para-conseguir-votos-para-dilma.html.txt
371,8,-2,impeachment-dilma,epoca,250,4,2,3,203,9,17,30,epoca.globo.com___tempo_noticia_2016_04_manifestantes-pro-impeachment-se-reunem-na-paulista-em-clima-de-festa.html.txt
372,25,-26,impeachment-dilma,epoca,569,45,19,4,472,37,62,66,epoca.globo.com___tempo_noticia_2016_04_michel-temer-o-vice-nao-e-mais-decorativo.html.txt
373,13,15,impeachment-dilma,epoca,579,12,27,4,477,29,42,74,epoca.globo.com___tempo_noticia_2016_04_o-muro-na-esplanada-representa-simbolicamente-divisao-do-brasil.html.txt
374,0,0,impeachment-dilma,epoca,0,0,0,0,0,0,0,0,epoca.globo.com___tempo_noticia_2016_04_o-placar-da-votacao-do-impeachment.html.txt
375,-15,-13,impeachment-dilma,epoca,904,32,19,5,749,59,44,108,epoca.globo.com___tempo_noticia_2016_04_o-primeiro-dia-de-sessao-da-votacao-do-impeachment-de-dilma.html.txt
376,6,-2,impeachment-dilma,epoca,270,9,7,0,211,17,23,35,epoca.globo.com___tempo_noticia_2016_04_solidao-de-dilma-rousseff.html.txt
377,7,11,impeachment-dilma,epoca,367,0,11,0,317,12,19,30,epoca.globo.com___tempo_noticia_2016_04_stf-nega-liminar-e-mantem-votacao-de-impeachment-da-forma-como-cunha-definiu.html.txt
378,44,-18,impeachment-dilma,epoca,1037,47,29,16,807,63,107,152,epoca.globo.com___tempo_noticia_2016_04_temer-se-surpreende-com-quantidade-de-traidores-de-dilma.html.txt
379,-2,-3,impeachment-dilma,epoca,120,5,2,2,100,7,5,17,epoca.globo.com___tempo_noticia_2016_05_aecio-pedaladas-fiscais-provocaram-instabilidade-no-pais.html.txt
380,-6,-6,impeachment-dilma,epoca,220,10,4,1,164,19,13,39,epoca.globo.com___tempo_noticia_2016_05_cotado-como-ministro-osmar-terra-rebate-acusacoes-de-dilma-sobre-possivel-quebra-do-bolsa-familia.html.txt
381,46,-10,impeachment-dilma,epoca,1073,48,38,4,911,40,86,126,epoca.globo.com___tempo_noticia_2016_05_dilma-e-afastada-e-temer-assume-o-governo.html.txt
382,-5,6,impeachment-dilma,epoca,703,13,19,8,588,44,39,72,epoca.globo.com___tempo_noticia_2016_05_dilma-varias-vidas-e-uma-morte-politica.html.txt
383,1,-1,impeachment-dilma,epoca,92,3,2,0,71,4,5,17,epoca.globo.com___tempo_noticia_2016_05_marta-suplicy-impeachment-vai-criar-uma-nova-historia-para-o-pais.html.txt
384,9,9,impeachment-dilma,epoca,429,7,16,2,344,17,26,67,epoca.globo.com___tempo_noticia_2016_05_meirelles-o-ministro-de-temer-que-lula-quis-para-dilma.html.txt
385,4,-3,impeachment-dilma,epoca,292,9,6,1,219,23,27,39,epoca.globo.com___tempo_noticia_2016_05_o-rombo-e-de-r-170-bilhoes.html.txt
386,-6,1,impeachment-dilma,epoca,155,4,5,2,128,12,6,20,epoca.globo.com___tempo_noticia_2016_05_presidente-interino-da-camara-anula-processo-do-impeachment.html.txt
387,26,-8,impeachment-dilma,epoca,3960,98,90,37,3259,202,228,496,epoca.globo.com___tempo_noticia_2016_05_senado-vota-abertura-do-processo-de-impeachment-de-dilma-rousseff.html.txt
388,4,2,impeachment-dilma,epoca,120,0,2,1,94,3,7,19,epoca.globo.com___tempo_noticia_2016_07_julgamento-final-do-impeachment-de-dilma-rousseff-ja-tem-data.html.txt
389,-3,4,impeachment-dilma,epoca,314,4,8,1,247,22,19,39,epoca.globo.com___tempo_noticia_2016_08_dilma-vira-re.html.txt
390,19,7,impeachment-dilma,epoca,453,4,11,6,399,9,28,38,epoca.globo.com___tempo_noticia_2016_09_aposentadoria-jato-de-dilma.html.txt
391,12,1,soltura-lula,epoca,480,15,16,3,382,20,32,80,epoca.globo.com___thiago-prado_a-pauta-nao-pode-mais-ser-lula-livre-diz-marcelo-freixo-23229184.txt
392,-3,-3,afastamento-aecio,epoca,194,5,2,1,167,11,8,16,epoca.globo.com___tudo-sobre_noticia_2017_05_joesley-batista.html.txt
393,10,1,reforma-trabalhista,epoca,236,3,4,4,192,6,16,33,epocanegocios.globo.com___Brasil_noticia_2017_04_epoca-negocios-fim-da-contribuicao-sindical-acaba-com-sindicatos-nao-serios-diz-relatorudo.html.txt
394,6,-2,reforma-trabalhista,epoca,130,3,1,2,95,8,14,19,epocanegocios.globo.com___Brasil_noticia_2017_04_epoca-negocios-oposicao-vai-tentar-adiar-votacao-da-reforma-trabalhista-no-plenario-da-camara.html.txt
395,6,-1,reforma-trabalhista,epoca,125,2,1,1,99,4,10,16,epocanegocios.globo.com___Brasil_noticia_2017_04_lula-reforma-trabalhista-de-temer-e-volta-escravidao.html.txt
396,4,5,reforma-trabalhista,epoca,145,1,6,2,120,6,10,18,epocanegocios.globo.com___Brasil_noticia_2017_04_pcdob-pede-stf-que-suspenda-votacao-de-reforma-trabalhista-na-camara.html.txt
397,2,-1,reforma-trabalhista,epoca,209,5,4,0,180,5,7,26,epocanegocios.globo.com___Brasil_noticia_2017_05_brasilia-termina-maior-manifestacao-contra-governo-temer.html.txt
398,6,-9,afastamento-aecio,epoca,308,11,2,1,233,21,27,41,epocanegocios.globo.com___Brasil_noticia_2017_05_epoca-negocios-apos-camara-bancada-do-psdb-do-senado-discute-eventual-desembarque-do-governo.html.txt
399,4,-1,afastamento-aecio,epoca,314,4,3,0,263,19,23,16,epocanegocios.globo.com___Brasil_noticia_2017_05_epoca-negocios-em-grampo-da-operacao-patmos-irma-de-aecio-pede-integra-de-delacao-da-odebrecht.html.txt
400,-11,4,afastamento-aecio,epoca,243,4,8,1,214,19,8,15,epocanegocios.globo.com___Brasil_noticia_2017_05_epoca-negocios-procuradoria-apura-se-pagamento-de-publicidade-ocultou-doacao-a-aecio.html.txt
401,1,1,afastamento-aecio,epoca,172,2,3,2,129,14,15,21,epocanegocios.globo.com___Brasil_noticia_2017_05_epoca-negocios-sao-tempos-estranhos-geradores-de-grande-perplexidade-diz-ministro-do-stf.html.txt
402,7,-8,afastamento-aecio,epoca,138,9,1,1,124,3,10,12,epocanegocios.globo.com___Brasil_noticia_2017_05_lula-retira-fotos-de-moro-com-temer-e-aecio-de-rede-social.html.txt
403,2,0,reforma-trabalhista,epoca,78,2,2,0,60,5,7,10,epocanegocios.globo.com___Brasil_noticia_2017_05_temer-recebe-ministros-e-parlamentares-no-alvorada-para-debater-reformas.html.txt
404,2,-3,afastamento-aecio,epoca,191,7,4,0,156,12,14,20,epocanegocios.globo.com___Brasil_noticia_2017_06_epoca-negocios-doria-quer-aecio-fora-do-comando-tucano.html.txt
405,-1,2,reforma-trabalhista,epoca,125,0,2,1,108,4,3,13,epocanegocios.globo.com___Brasil_noticia_2017_06_epoca-negocios-senadores-discutem-restricoes-de-entrada-em-sessao-para-votar-parecer-de-reforma.html.txt
406,-3,-1,reforma-trabalhista,epoca,107,3,2,1,75,9,6,23,epocanegocios.globo.com___Brasil_noticia_2017_06_epoca-negocios-setubal-defende-aprovacao-da-reforma-trabalhista.html.txt
407,-3,-3,afastamento-aecio,epoca,162,9,6,2,137,16,13,13,epocanegocios.globo.com___Brasil_noticia_2017_06_epoca-negocios-torcer-pela-prisao-de-aecio-e-equivoco-diz-lider-do-pt-na-camara.html.txt
408,0,1,reforma-trabalhista,epoca,90,1,2,0,73,5,5,10,epocanegocios.globo.com___Brasil_noticia_2017_07_carmen-lucia-nega-pedido-para-suspender-tramitacao-da-reforma-trabalhista.html.txt
409,-5,-5,reforma-trabalhista,epoca,353,9,4,2,299,24,19,26,epocanegocios.globo.com___Brasil_noticia_2017_07_corte-em-ministerio-ameaca-servicos-aos-trabalhadores.html.txt
410,-1,-3,afastamento-aecio,epoca,105,3,0,1,92,6,5,6,epocanegocios.globo.com___Brasil_noticia_2017_07_epoca-negocios-aecio-ja-se-afastou-e-presidente-do-psdb-e-tasso-jereissati-diz-alckmin.html.txt
411,-6,0,reforma-trabalhista,epoca,87,0,0,0,73,7,1,6,epocanegocios.globo.com___Brasil_noticia_2017_07_epoca-negocios-senador-romero-juca-sera-o-relator-da-reforma-trabalhista-na-sessao-do-plenario.html.txt
412,15,-7,reforma-trabalhista,epoca,255,12,5,2,186,19,34,35,epocanegocios.globo.com___Brasil_noticia_2017_07_imposto-sindical-ja-nao-sera-mais-cobrado-partir-do-ano-que-vem.html.txt
413,9,1,reforma-trabalhista,epoca,171,3,4,1,138,4,13,24,epocanegocios.globo.com___Brasil_noticia_2017_07_oit-diz-que-reforma-trabalhista-viola-regras-internacionais.html.txt
414,0,-4,reforma-trabalhista,epoca,108,4,0,1,87,8,8,10,epocanegocios.globo.com___Brasil_noticia_2017_07_senadoras-ocupam-mesa-do-senado-e-sessao-da-reforma-trabalhista-e-suspensa.html.txt
415,7,-8,afastamento-aecio,epoca,194,11,3,0,162,10,17,19,epocanegocios.globo.com___Brasil_noticia_2017_08_psdb-mantem-aecio-afastado-da-presidencia-do-partido-tasso-permanece-interino.html.txt
416,22,1,reforma-trabalhista,epoca,418,8,9,5,328,21,43,48,epocanegocios.globo.com___Brasil_noticia_2017_08_reforma-trabalhista-endurece-regras-para-calculo-de-hora-extra.html.txt
417,7,2,reforma-trabalhista,epoca,329,5,7,1,264,20,27,31,epocanegocios.globo.com___Brasil_noticia_2017_08_reforma-trabalhista-permitira-troca-de-dia-de-feriados.html.txt
418,-19,-24,afastamento-aecio,epoca,511,27,3,5,407,48,29,62,epocanegocios.globo.com___Brasil_noticia_2017_08_tucanos-governistas-se-mostram-constrangidos-com-o-psdb-errou.html.txt
419,-4,2,afastamento-aecio,epoca,174,2,4,2,142,17,13,10,epocanegocios.globo.com___Brasil_noticia_2017_10_presidente-do-conselho-de-etica-decide-arquivar-representacao-contra-aecio-neves.html.txt
420,-3,5,afastamento-aecio,epoca,245,4,9,3,210,19,16,16,epocanegocios.globo.com___Brasil_noticia_2017_10_senado-derruba-afastamento-parlamentar-de-aecio-neves-imposto-pelo-stf.html.txt
421,1,3,reforma-trabalhista,epoca,152,4,7,1,119,13,14,18,epocanegocios.globo.com___Brasil_noticia_2017_11_entenda-diferencas-entre-trabalho-intermitente-temporario-e-jornada-parcial.html.txt
422,60,9,reforma-trabalhista,epoca,623,12,21,3,471,23,83,82,epocanegocios.globo.com___Brasil_noticia_2017_11_epoca-negocios-a-nova-lei-trabalhista-perguntas-e-respostas.html.txt
423,8,3,reforma-trabalhista,epoca,169,0,3,5,138,4,12,23,epocanegocios.globo.com___Brasil_noticia_2017_11_hora-de-trabalhador-intermitente-nao-pode-ser-inferior-ao-minimo.html.txt
424,4,3,reforma-trabalhista,epoca,235,8,11,1,186,17,21,31,epocanegocios.globo.com___Brasil_noticia_2017_11_reforma-trabalhista-deve-inibir-acoes-aventureiras.html.txt
425,17,4,reforma-trabalhista,epoca,206,3,7,0,166,3,20,27,epocanegocios.globo.com___Brasil_noticia_2017_11_reforma-trabalhista-trabalho-interminente-gera-duvidas.html.txt
426,9,2,prisao-lula,epoca,211,3,5,2,162,6,15,38,epocanegocios.globo.com___Brasil_noticia_2018_04_prisao-de-lula-acelera-tendencia-conservadora-na-america-latina-diz-wall-street-journal.html.txt
427,-1,-4,prisao-lula,epoca,151,9,5,1,135,10,9,12,epocanegocios.globo.com___Brasil_noticia_2018_04_sergio-moro-determina-prisao-do-ex-presidente-lula.html.txt
428,0,0,prisao-lula,epoca,385,14,14,1,326,25,25,38,epocanegocios.globo.com___Brasil_noticia_2018_05_carmen-lucia-volta-defender-prisao-em-2-instancia.html.txt
429,-5,-4,prisao-lula,epoca,181,5,1,0,169,6,1,11,epocanegocios.globo.com___Brasil_noticia_2018_06_lula-lidera-corrida-presidencial-diz-pesquisa-datafolha-sem-ele-marina-vence-bolsonaro-ciro-e-alckmin.html.txt
430,-3,1,prisao-lula,epoca,175,5,6,1,165,9,6,7,epocanegocios.globo.com___Brasil_noticia_2018_07_desembargador-manda-soltar-o-ex-presidente-lula.html.txt
431,-2,-6,prisao-lula,epoca,78,7,1,0,72,5,3,6,epocanegocios.globo.com___Brasil_noticia_2018_07_justica-nega-pedido-para-declarar-moro-suspeito-para-julgar-lula.html.txt
432,-1,5,reforma-previdencia,epoca,209,2,7,0,170,12,11,25,epocanegocios.globo.com___Brasil_noticia_2019_02_epoca-negocios-guedes-reforma-e-para-reduzir-desigualdades-e-eliminar-privilegios.html.txt
433,1,0,reforma-previdencia,epoca,143,2,2,0,99,11,12,25,epocanegocios.globo.com___Brasil_noticia_2019_02_lider-diz-que-governo-nao-quer-desfigurar-reforma-da-previdencia.html.txt
434,0,-1,reforma-previdencia,epoca,325,2,1,0,277,8,8,35,epocanegocios.globo.com___Brasil_noticia_2019_02_reforma-da-previdencia-podera-criar-8-milhoes-de-empregos-ate-2023.html.txt
435,9,2,reforma-previdencia,epoca,237,3,5,2,195,7,16,29,epocanegocios.globo.com___Brasil_noticia_2019_02_transicao-em-reforma-da-previdencia-vai-durar-ate-14-anos.html.txt
436,2,3,reforma-previdencia,epoca,138,0,3,0,103,4,6,28,epocanegocios.globo.com___Brasil_noticia_2019_03_epoca-negocios-pais-depende-da-reforma-da-previdencia-para-avancar-diz-bolsonaro.html.txt
437,4,0,reforma-previdencia,epoca,172,3,3,0,145,7,11,15,epocanegocios.globo.com___Brasil_noticia_2019_03_reforma-da-previdencia-cria-guerra-de-hashtags-no-twitter.html.txt
438,1,7,reforma-previdencia,epoca,135,4,11,0,112,9,10,19,epocanegocios.globo.com___Brasil_noticia_2019_03_reforma-da-previdencia-criara-confianca-que-o-pais-precisa-diz-mourao.html.txt
439,4,5,reforma-previdencia,epoca,330,3,8,2,280,15,19,29,epocanegocios.globo.com___Brasil_noticia_2019_04_economia-com-reforma-da-previdencia-sobe-r-123-trilhoes.html.txt
440,0,2,reforma-previdencia,epoca,85,0,2,0,73,4,4,6,epocanegocios.globo.com___Brasil_noticia_2019_04_guedes-reforma-da-previdencia-deve-atingir-r-1-trilhao-que-e-o-que-queremos.html.txt
441,5,5,reforma-previdencia,epoca,122,0,5,1,100,2,7,19,epocanegocios.globo.com___Brasil_noticia_2019_05_epoca-negocios-governo-anuncia-campanha-em-apoio-a-reforma-da-previdencia.html.txt
442,3,-3,reforma-previdencia,epoca,382,11,8,2,300,30,33,40,epocanegocios.globo.com___Brasil_noticia_2019_05_guedes-diz-que-reforma-da-previdencia-deve-ser-aprovada-em-ate-90-dias.html.txt
443,10,1,reforma-previdencia,epoca,367,1,2,5,297,11,21,46,epocanegocios.globo.com___Brasil_noticia_2019_06_governadores-buscam-consenso-minimo-para-reforma-da-previdencia.html.txt
444,15,9,reforma-previdencia,epoca,664,3,12,7,521,19,34,112,epocanegocios.globo.com___Brasil_noticia_2019_06_o-que-muda-na-reforma-da-previdencia-com-o-relatorio-da-comissao-especial.html.txt
445,10,6,reforma-previdencia,epoca,600,4,10,4,463,30,40,85,epocanegocios.globo.com___Brasil_noticia_2019_06_reforma-da-previdencia-4-pontos-que-ainda-estao-em-discussao.html.txt
446,12,3,reforma-previdencia,epoca,342,5,8,3,266,15,27,50,epocanegocios.globo.com___Brasil_noticia_2019_07_guedes-elogia-ideia-para-reincluir-estados-na-reforma-da-previdencia.html.txt
447,3,1,reforma-previdencia,epoca,320,2,3,1,280,7,10,29,epocanegocios.globo.com___Brasil_noticia_2019_08_senado-cobra-ajuda-para-estados-em-troca-da-reforma-da-previdencia.html.txt
448,-1,1,reforma-previdencia,epoca,401,4,5,2,329,21,20,42,epocanegocios.globo.com___Brasil_noticia_2019_09_pec-paralela-da-reforma-da-previdencia-corre-riscos-no-senado.html.txt
449,24,3,reforma-previdencia,epoca,890,13,16,4,691,43,67,122,epocanegocios.globo.com___Brasil_noticia_2019_09_por-que-reforma-da-previdencia-que-exclui-estados-e-municipios-pode-ser-insuficiente.html.txt
450,1,5,reforma-previdencia,epoca,296,3,8,4,245,17,18,31,epocanegocios.globo.com___Brasil_noticia_2019_09_senado-abre-prazo-de-5-sessoes-para-votacao-da-reforma-da-previdencia.html.txt
451,29,9,reforma-previdencia,epoca,432,1,10,2,331,15,44,55,epocanegocios.globo.com___Brasil_noticia_2019_09_senado-tera-semana-de-negociacoes-para-votar-reforma-da-previdencia.html.txt
452,8,0,reforma-previdencia,epoca,219,3,3,3,179,8,16,25,epocanegocios.globo.com___Brasil_noticia_2019_10_comeca-reuniao-da-ccj-para-votar-relatorio-da-reforma-da-previdencia.html.txt
453,27,18,reforma-previdencia,epoca,835,3,21,4,683,22,49,109,epocanegocios.globo.com___Brasil_noticia_2019_10_entenda-regras-de-transicao-da-reforma-da-previdencia.html.txt
454,0,1,reforma-previdencia,epoca,120,2,3,3,91,7,7,23,epocanegocios.globo.com___Brasil_noticia_2019_10_previdencia-governo-derruba-destaque-na-reforma-dos-militares-que-teria-impacto-de-r-130-bi.html.txt
455,10,9,reforma-previdencia,epoca,511,8,17,6,404,25,35,78,epocanegocios.globo.com___Brasil_noticia_2019_10_previdencia-mudancas-aprovadas-no-texto-da-reforma-beneficiam-os-mais-pobres.html.txt
456,5,8,reforma-previdencia,epoca,459,7,15,3,380,22,27,55,epocanegocios.globo.com___Brasil_noticia_2019_10_reforma-da-previdencia-e-concluida-com-economia-prevista-de-r-800-bi.html.txt
457,2,1,reforma-previdencia,epoca,212,0,1,1,175,6,8,25,epocanegocios.globo.com___Brasil_noticia_2019_11_epoca-negocios-emenda-constitucional-da-reforma-da-previdencia-e-publicada.html.txt
458,4,2,reforma-previdencia,epoca,172,1,3,2,135,6,10,27,epocanegocios.globo.com___Brasil_noticia_2019_12_senado-aprova-reforma-da-previdencia-dos-militares.html.txt
459,34,15,reforma-trabalhista,epoca,337,0,15,2,251,8,42,53,epocanegocios.globo.com___Carreira_noticia_2017_04_quantos-dias-de-folga-posso-tirar-apos-meu-casamento.html.txt
460,27,12,reforma-trabalhista,epoca,565,6,18,3,447,25,52,68,epocanegocios.globo.com___Carreira_noticia_2017_07_reforma-trabalhista-como-funciona-o-trabalho-intermitente.html.txt
461,20,5,reforma-trabalhista,epoca,436,9,14,1,338,22,42,58,epocanegocios.globo.com___Carreira_noticia_2017_07_reforma-trabalhista-entenda-como-funciona-demissao-consensual.html.txt
462,22,8,reforma-trabalhista,epoca,397,2,10,0,311,14,36,48,epocanegocios.globo.com___Carreira_noticia_2017_07_reforma-trabalhista-funcionarios-com-alto-salario-podem-negociar-sem-o-sindicato.html.txt
463,39,23,reforma-trabalhista,epoca,414,4,27,3,317,16,55,60,epocanegocios.globo.com___Carreira_noticia_2017_07_reforma-trabalhista-libera-pejotizacao-nas-empresas.html.txt
464,32,8,reforma-trabalhista,epoca,455,2,10,5,346,19,51,56,epocanegocios.globo.com___Carreira_noticia_2017_07_reforma-trabalhista-o-que-deixa-de-contar-como-hora-trabalhada.html.txt
465,4,4,reforma-trabalhista,epoca,319,5,9,0,252,23,27,31,epocanegocios.globo.com___Carreira_noticia_2017_07_reforma-trabalhista-sindicato-nao-precisara-mais-homologar-rescisao.html.txt
466,6,7,reforma-trabalhista,epoca,284,5,12,2,227,16,22,38,epocanegocios.globo.com___Carreira_noticia_2017_09_terceirizacao-nao-precariza-emprego-aponta-estudo-da-usp.html.txt
467,27,15,reforma-trabalhista,epoca,722,3,18,4,578,26,53,90,epocanegocios.globo.com___Economia_noticia_2017_04_10-pontos-que-reforma-trabalhista-muda-clt.html.txt
468,29,5,reforma-trabalhista,epoca,459,6,11,2,351,18,47,62,epocanegocios.globo.com___Economia_noticia_2017_04_com-flexibilizacao-de-varios-pontos-da-clt-reforma-trabalhista-divide-opinioes.html.txt
469,10,2,reforma-trabalhista,epoca,412,6,8,4,322,22,32,54,epocanegocios.globo.com___Economia_noticia_2017_04_reforma-trabalhista-pode-permitir-microempreendedor-terceirizado.html.txt
470,1,-5,reforma-trabalhista,epoca,281,7,2,1,213,16,17,45,epocanegocios.globo.com___Economia_noticia_2017_05_epoca-negocios-area-economica-analisa-impacto-de-acusacoes-e-teme-que-retomada-seja-interrompida.html.txt
471,11,1,reforma-trabalhista,epoca,587,14,15,4,440,33,44,103,epocanegocios.globo.com___Economia_noticia_2017_06_estudo-preve-potencial-para-reforma-trabalhista-criar-23-milhoes-de-vagas.html.txt
472,6,-1,reforma-trabalhista,epoca,361,9,8,3,288,25,31,37,epocanegocios.globo.com___Economia_noticia_2017_07_governo-quer-acelerar-reforma-trabalhista.html.txt
473,10,3,reforma-trabalhista,epoca,462,6,9,9,362,22,32,70,epocanegocios.globo.com___Economia_noticia_2017_09_mercado-de-trabalho-no-futuro-tera-jornadas-e-salarios-menores.html.txt
474,20,11,reforma-trabalhista,epoca,270,1,12,2,214,12,32,27,epocanegocios.globo.com___Economia_noticia_2017_10_empresas-ja-oferecem-vagas-pela-nova-clt.html.txt
475,19,-7,reforma-trabalhista,epoca,564,12,5,0,401,35,54,91,epocanegocios.globo.com___Economia_noticia_2017_11_epoca-negocios-apos-reforma-trabalhista-sindicatos-encolhem-e-demitem-para-sobreviver.html.txt
476,19,1,reforma-trabalhista,epoca,314,3,4,2,240,11,30,42,epocanegocios.globo.com___Economia_noticia_2017_11_epoca-negocios-com-nova-regra-empregado-intermitente-podera-ter-de-pagar-para-trabalhar.html.txt
477,18,14,reforma-previdencia,epoca,632,0,14,0,520,15,33,78,epocanegocios.globo.com___Economia_noticia_2019_02_reforma-da-previdencia-entenda-o-que-muda-segundo-o-projeto-apresentado-pelo-governo.html.txt
478,-3,1,reforma-previdencia,epoca,285,3,4,1,243,12,9,29,epocanegocios.globo.com___Economia_noticia_2019_03_uniao-tera-dificuldade-em-pagar-salarios-sem-reforma-da-previdencia.html.txt
479,9,7,reforma-previdencia,epoca,298,1,8,2,222,13,22,52,epocanegocios.globo.com___Economia_noticia_2019_05_epoca-negocios-reforma-da-previdencia-deve-forcar-pais-a-poupar-mais.html.txt
480,19,4,reforma-previdencia,epoca,315,3,7,4,257,6,25,41,epocanegocios.globo.com___Economia_noticia_2019_07_epoca-negocios-otimismo-com-reforma-da-previdencia-leva-ibovespa-a-novo-recorde.html.txt
481,24,15,reforma-previdencia,epoca,790,6,21,5,662,22,46,92,epocanegocios.globo.com___Economia_noticia_2019_07_reforma-da-previdencia-o-que-muda-na-sua-aposentadoria-com-o-texto-aprovado-pela-camara.html.txt
482,-1,-3,reforma-previdencia,epoca,243,7,4,0,203,12,11,28,epocanegocios.globo.com___Economia_noticia_2019_08_reforma-da-previdencia-segue-para-o-senado-com-economia-de-r-933-bilhoes.html.txt
483,1,-3,reforma-previdencia,epoca,315,5,2,2,259,13,14,38,epocanegocios.globo.com___Economia_noticia_2019_08_relator-desidrata-reforma-da-previdencia-em-r-31-bilhoes.html.txt
484,17,6,reforma-previdencia,epoca,183,3,9,1,149,4,21,22,epocanegocios.globo.com___Economia_noticia_2019_10_apos-acordo-senado-conclui-votacao-da-reforma-da-previdencia.html.txt
485,14,1,prisao-lula,epoca,817,19,20,3,685,27,41,106,epocanegocios.globo.com___Mundo_noticia_2018_05_confira-como-foram-manifestacoes-do-dia-do-trabalhado-no-brasil-e-no-mundo.html.txt
486,-1,-2,prisao-lula,epoca,198,4,2,0,163,14,13,14,epocanegocios.globo.com___Tecnologia_noticia_2018_06_pt-considera-usar-holograma-em-lancamento-de-pre-candidatura-de-lula.html.txt
487,8,2,reforma-trabalhista,epoca,170,1,3,2,142,2,10,22,epocanegocios.globo.com___estadao_noticia_2017_11_epoca-negocios-lg-alterou-contratos-um-dia-antes-da-entrada-em-vigor-da-nova-lei-trabalhista.html.txt
488,6,-7,prisao-lula,estadao,179,8,1,0,148,5,11,24,"esportes.estadao.com.br___noticias_futebol,mesmo-preso-lula-estreia-na-2-feira-como-comentarista-da-copa-do-mundo,70002351426.txt"
489,-8,-1,prisao-lula,g1,228,3,2,0,188,17,9,19,g1.globo.com___al_alagoas_noticia_manifestantes-fecham-br-101-em-al-contra-pedido-de-prisao-de-lula.ghtml.txt
490,0,3,reforma-trabalhista,g1,315,5,8,0,259,16,16,37,g1.globo.com___ap_amapa_noticia_nova-lei-trabalhista-e-tema-de-debate-com-empresarios-e-trabalhadores-em-macapa.ghtml.txt
491,-6,-3,reforma-trabalhista,g1,264,10,7,0,212,23,17,29,g1.globo.com___bahia_noticia_no-1-dia-de-vigencia-da-reforma-trabalhista-juiz-na-bahia-condena-funcionario-a-pagar-r-85-mil-por-suposta-conduta-de-ma-fe.ghtml.txt
492,1,-2,soltura-lula,g1,171,8,6,0,159,9,10,7,g1.globo.com___ce_ceara_noticia_2019_11_08_atos-em-fortaleza-celebram-soltura-de-lula.ghtml.txt
493,-7,12,impeachment-dilma,g1,345,0,12,2,272,24,17,46,g1.globo.com___distrito-federal_noticia_2016_08_prevendo-baixo-publico-gdf-desiste-de-muro-do-impeachment.html.txt
494,6,3,afastamento-aecio,g1,384,3,6,3,316,15,21,44,g1.globo.com___distrito-federal_noticia_pedrinho-raptado-em-maternidade-de-brasilia-atua-como-advogado-de-aecio.ghtml.txt
495,18,12,reforma-trabalhista,g1,416,5,17,2,330,20,38,52,g1.globo.com___economia_blog_thais-heredia_post_nova-lei-trabalhista-aproxima-brasil-dos-paises-desenvolvidos.html.txt
496,12,3,reforma-trabalhista,g1,374,15,18,12,314,13,25,67,g1.globo.com___economia_blog_thais-heredia_post_virada-liberal-um-ano-de-temer.html.txt
497,58,40,reforma-trabalhista,g1,865,12,52,9,680,35,93,130,g1.globo.com___economia_concursos-e-emprego_noticia_mp-que-ajusta-nova-lei-trabalhista-veda-seguro-desemprego-para-trabalhador-intermitente-entenda-as-mudancas.ghtml.txt
498,65,21,reforma-trabalhista,g1,811,5,26,6,629,23,88,108,g1.globo.com___economia_concursos-e-emprego_noticia_nova-lei-trabalhista-entra-em-vigor-no-sabado-veja-as-principais-mudancas.ghtml.txt
499,-1,-10,afastamento-aecio,g1,328,12,2,1,277,18,17,31,g1.globo.com___economia_negocios_noticia_jbs-anuncia-programa-de-desinvestimentos-de-r-6-bilhoes.ghtml.txt
500,7,0,reforma-previdencia,g1,249,2,2,1,199,9,16,30,g1.globo.com___economia_noticia_2019_02_05_guedes-diz-que-intencao-e-economizar-r-1-trilhao-em-dez-anos-com-reforma-da-previdencia.ghtml.txt
501,10,-1,reforma-previdencia,g1,907,10,9,7,739,23,33,138,g1.globo.com___economia_noticia_2019_02_20_reforma-da-previdencia-entenda-a-proposta-ponto-a-ponto.ghtml.txt
502,8,6,reforma-previdencia,g1,424,0,6,0,392,4,12,22,g1.globo.com___economia_noticia_2019_02_20_reforma-da-previdencia-veja-simulacoes.ghtml.txt
503,4,1,reforma-previdencia,g1,345,2,3,3,277,14,18,44,g1.globo.com___economia_noticia_2019_03_20_reforma-da-previdencia-dos-militares-entenda-a-proposta-ponto-a-ponto.ghtml.txt
504,4,-1,reforma-previdencia,g1,288,9,8,1,231,17,21,37,g1.globo.com___economia_noticia_2019_05_24_guedes-diz-que-pode-renunciar-se-reforma-da-previdencia-nao-sair.ghtml.txt
505,46,17,reforma-previdencia,g1,1664,12,29,10,1381,34,80,220,g1.globo.com___economia_noticia_2019_07_05_reforma-da-previdencia-entenda-ponto-a-ponto-a-proposta-que-vai-ao-plenario-da-camara.ghtml.txt
506,7,0,reforma-previdencia,g1,423,2,2,2,364,7,14,44,g1.globo.com___economia_noticia_2019_10_03_desidratacao-da-reforma-da-previdencia-sera-compensada-no-pacto-federativo-diz-secretario.ghtml.txt
507,35,15,reforma-previdencia,g1,1748,14,29,17,1435,44,79,250,g1.globo.com___economia_noticia_2019_10_22_reforma-da-previdencia-entenda-ponto-a-ponto-a-proposta-aprovada-em-2o-turno-no-senado.ghtml.txt
508,-1,-2,soltura-lula,g1,172,5,3,2,148,6,5,23,g1.globo.com___economia_noticia_2019_11_08_bovespa.ghtml.txt
509,40,15,reforma-previdencia,g1,2044,14,29,17,1692,43,83,286,g1.globo.com___economia_noticia_2019_11_12_saiba-o-que-muda-com-a-reforma-da-previdencia.ghtml.txt
510,5,-1,soltura-lula,g1,251,4,3,0,197,8,13,40,g1.globo.com___economia_noticia_2019_11_14_dolar.ghtml.txt
511,25,8,reforma-trabalhista,g1,222,1,9,0,157,9,34,32,g1.globo.com___economia_noticia_com-fim-da-contribuicao-obrigatoria-ministro-estima-que-mais-de-3-mil-sindicatos-desaparecerao.ghtml.txt
512,40,-11,reforma-trabalhista,g1,847,18,7,2,677,41,81,75,g1.globo.com___economia_noticia_como-a-reforma-trabalhista-pode-afetar-os-sindicatos-e-seus-150-mil-funcionarios.ghtml.txt
513,73,20,reforma-trabalhista,g1,988,16,36,6,787,41,114,104,g1.globo.com___economia_noticia_confira-o-que-pode-mudar-com-a-reforma-trabalhista.ghtml.txt
514,13,-2,reforma-trabalhista,g1,246,6,4,1,179,17,30,31,g1.globo.com___economia_noticia_contribuicao-sindical-sera-opcional-na-nova-lei-trabalhista-entenda-o-que-mudou.ghtml.txt
515,6,-2,prisao-lula,g1,248,8,6,0,201,10,16,35,g1.globo.com___economia_noticia_cotacao-dolar-050418.ghtml.txt
516,66,9,reforma-trabalhista,g1,1028,7,16,9,806,37,103,114,g1.globo.com___economia_noticia_empresas-devem-adotar-gradativamente-novidades-da-lei-trabalhista.ghtml.txt
517,40,5,reforma-trabalhista,g1,1130,3,8,0,905,13,53,170,g1.globo.com___economia_noticia_entenda-a-regra-de-transicao-da-reforma-da-previdencia-e-veja-simulacoes.ghtml.txt
518,27,18,reforma-trabalhista,g1,382,0,18,2,303,11,38,50,g1.globo.com___economia_noticia_ferias-ficam-mais-flexiveis-com-a-nova-lei-trabalhista-veja-o-que-muda.ghtml.txt
519,38,9,reforma-trabalhista,g1,542,4,13,5,424,21,59,60,g1.globo.com___economia_noticia_nova-lei-trabalhista-banco-de-horas-podera-ser-negociado-diretamente-com-o-patrao-entenda.ghtml.txt
520,24,18,reforma-trabalhista,g1,553,1,19,3,421,24,48,83,g1.globo.com___economia_noticia_nova-lei-trabalhista-cria-regras-para-home-office-entenda.ghtml.txt
521,14,7,reforma-trabalhista,g1,296,4,11,0,227,16,30,38,g1.globo.com___economia_noticia_nova-lei-trabalhista-preve-demissao-por-acordo-entenda.ghtml.txt
522,45,23,reforma-trabalhista,g1,714,5,28,10,555,31,76,95,g1.globo.com___economia_noticia_nova-lei-trabalhista-regulamenta-o-trabalho-esporadico-entenda.ghtml.txt
523,16,3,reforma-trabalhista,g1,408,6,9,0,302,25,41,55,g1.globo.com___economia_noticia_nova-lei-trabalhista-rescisao-nao-precisa-mais-de-homologacao-no-sindicato-entenda.ghtml.txt
524,29,3,reforma-trabalhista,g1,374,3,6,2,283,13,42,47,g1.globo.com___economia_noticia_nova-lei-trabalhista-vai-gerar-mais-de-6-milhoes-de-empregos-diz-meirelles.ghtml.txt
525,59,15,reforma-trabalhista,g1,668,0,15,5,533,16,75,64,g1.globo.com___economia_noticia_nova-lei-trabalhista-veja-pontos-que-precisam-de-negociacao-para-entrar-em-vigor.ghtml.txt
526,26,10,reforma-trabalhista,g1,561,4,14,3,441,28,54,59,g1.globo.com___economia_noticia_numero-de-acoes-judiciais-dispara-na-vespera-da-mudanca-da-lei-trabalhista.ghtml.txt
527,12,-1,reforma-trabalhista,g1,177,3,2,0,136,3,15,28,g1.globo.com___economia_noticia_reforma-trabalhista-cria-limite-para-terceirizacao-entenda-as-regras.ghtml.txt
528,70,19,reforma-trabalhista,g1,980,14,33,6,778,42,112,101,g1.globo.com___economia_noticia_reforma-trabalhista-e-aprovada-no-senado-confira-o-que-muda-na-lei.ghtml.txt
529,-1,-1,reforma-trabalhista,g1,102,3,2,1,74,7,6,21,g1.globo.com___economia_noticia_reforma-trabalhista-e-boa-para-os-consumidores-diz-roberto-setubal.ghtml.txt
530,13,8,reforma-trabalhista,g1,373,0,8,2,292,13,26,52,g1.globo.com___economia_noticia_reforma-trabalhista-e-publicada-no-diario-oficial-da-uniao.ghtml.txt
531,56,20,reforma-trabalhista,g1,866,8,28,8,681,28,84,117,g1.globo.com___economia_noticia_reforma-trabalhista-opoe-cni-e-cut-veja-o-que-pensam-empresarios-e-trabalhadores.ghtml.txt
532,6,0,reforma-trabalhista,g1,194,1,1,0,149,8,14,25,g1.globo.com___economia_noticia_reforma-trabalhista-vai-gerar-2-milhoes-de-empregos-em-dois-anos-diz-ministro.ghtml.txt
533,41,16,reforma-trabalhista,g1,680,5,21,3,529,19,60,101,g1.globo.com___economia_noticia_reforma-trabalhista-veja-ajustes-que-governo-deve-fazer-na-lei-que-comeca-a-vigora-neste-sabado.ghtml.txt
534,15,0,reforma-trabalhista,g1,179,4,4,0,141,7,22,17,g1.globo.com___economia_noticia_uruguai-questiona-nova-lei-trabalhista-brasileira-e-quer-discutir-tema-no-mercosul.ghtml.txt
535,-2,-1,soltura-lula,g1,247,3,2,0,197,10,8,37,g1.globo.com___fato-ou-fake_noticia_2019_11_11_e-fake-que-apresentadoras-e-reporteres-da-globo-usaram-vermelho-apos-lula-sair-da-prisao.ghtml.txt
536,2,2,soltura-lula,g1,58,0,2,0,53,0,2,5,g1.globo.com___fato-ou-fake_noticia_2019_11_11_e-fake-que-video-mostre-toffoli-comemorando-em-festa-apos-decisao-do-stf-contra-prisao-em-segunda-instancia.ghtml.txt
537,-1,-3,reforma-trabalhista,g1,785,15,12,3,686,26,25,78,g1.globo.com___goias_noticia_manifestantes-impedem-circulacao-de-onibus-do-eixo-anhanguera-em-goiania.ghtml.txt
538,-19,0,impeachment-dilma,g1,312,3,3,0,245,30,11,32,g1.globo.com___jornal-nacional_noticia_2016_06_pericia-conclui-que-dilma-nao-participou-de-pedaladas-fiscais.html.txt
539,-10,-2,reforma-trabalhista,g1,275,8,6,0,235,17,7,30,g1.globo.com___jornal-nacional_noticia_2017_03_brasil-tem-dia-de-protestos-contra-reformas-trabalhista-e-da-previdencia.html.txt
540,5,1,reforma-trabalhista,g1,195,1,2,1,146,7,12,34,g1.globo.com___jornal-nacional_noticia_2017_04_conheca-principais-mudancas-propostas-pelas-reformas.html.txt
541,-14,-10,afastamento-aecio,g1,534,19,9,2,426,46,32,60,g1.globo.com___jornal-nacional_noticia_2017_05_aecio-neves-e-afastado-da-funcao-de-senador-e-deixa-presidencia-do-psdb.html.txt
542,14,0,afastamento-aecio,g1,705,15,15,2,582,32,46,77,g1.globo.com___jornal-nacional_noticia_2017_05_joesley-pede-para-nomear-presidente-da-vale-em-troca-de-dinheiro-aecio.html.txt
543,15,-3,reforma-trabalhista,g1,442,12,9,1,374,16,31,43,g1.globo.com___jornal-nacional_noticia_2017_07_senadoras-da-oposicao-ocupam-mesa-do-plenario-e-impedem-votacao.html.txt
544,29,1,afastamento-aecio,g1,589,7,8,0,491,19,48,46,g1.globo.com___jornal-nacional_noticia_2017_10_assessoria-de-aecio-divulga-audio-de-andrea-neves-com-joesley.html.txt
545,17,8,reforma-trabalhista,g1,198,4,12,0,158,12,29,15,g1.globo.com___jornal-nacional_noticia_2017_11_reforma-trabalhista-tambem-traz-mudancas-para-acoes-na-justica.html.txt
546,19,3,reforma-trabalhista,g1,305,4,7,2,228,13,32,45,g1.globo.com___jornal-nacional_noticia_2017_11_veja-os-principais-pontos-das-novas-regras-da-reforma-trabalhista.html.txt
547,5,-6,prisao-lula,g1,738,23,17,7,656,33,38,58,g1.globo.com___jornal-nacional_noticia_2018_04_prisao-de-lula-e-consequencia-da-condenacao-no-caso-do-triplex.html.txt
548,-20,0,prisao-lula,g1,633,23,23,5,541,59,39,45,g1.globo.com___jornal-nacional_noticia_2018_07_lula-e-mais-seis-sao-absolvidos-da-acusacao-de-obstrucao-de-justica.html.txt
549,6,-1,prisao-lula,g1,192,2,1,1,147,6,12,31,g1.globo.com___jornal-nacional_noticia_2018_07_presidente-do-stj-rejeita-143-pedidos-de-habeas-corpus-para-lula.html.txt
550,4,-6,reforma-previdencia,g1,273,12,6,4,226,16,20,33,g1.globo.com___jornal-nacional_noticia_2019_07_15_senadores-estudam-proposta-paralela-para-incluir-estados-na-previdencia.ghtml.txt
551,31,3,reforma-previdencia,g1,463,4,7,3,355,18,49,55,g1.globo.com___jornal-nacional_noticia_2019_10_25_veja-como-ficaram-as-regras-de-transicao-para-a-aposentadoria-com-a-reforma-da-previdencia.ghtml.txt
552,-3,-6,impeachment-dilma,g1,201,9,3,1,162,11,8,33,g1.globo.com___mato-grosso_noticia_2016_07_manifestantes-fazem-protesto-em-mt-favor-do-impeachment-de-dilma.html.txt
553,0,4,afastamento-aecio,g1,183,1,5,1,152,14,14,10,g1.globo.com___minas-gerais_noticia_defesa-de-frederico-pacheco-primo-de-aecio-neves-entrega-dinheiro-em-agencia-da-caixa-em-bh.ghtml.txt
554,14,-10,afastamento-aecio,g1,737,18,8,2,626,33,47,59,g1.globo.com___minas-gerais_noticia_em-delacao-joesley-batista-diz-que-aecio-pediu-para-ele-comprar-imoveis-no-rio-e-em-bh-para-pagar-dividas.ghtml.txt
555,8,2,prisao-lula,g1,497,18,20,5,395,31,39,75,g1.globo.com___mundo_blog_helio-gurovitz_post_2018_03_23_lula-solto-stf-na-lona.ghtml.txt
556,2,-2,soltura-lula,g1,70,4,2,0,56,5,7,8,g1.globo.com___pb_paraiba_noticia_2019_11_08_manifestacao-a-favor-do-ex-presidente-lula-acontece-em-joao-pessoa.ghtml.txt
557,7,-6,soltura-lula,g1,155,9,3,1,138,4,11,15,g1.globo.com___pe_pernambuco_noticia_2019_11_08_militantes-se-reunem-no-recife-e-festejam-a-libertacao-de-lula.ghtml.txt
558,4,2,soltura-lula,g1,125,0,2,1,97,4,8,19,g1.globo.com___pe_pernambuco_noticia_2019_11_17_lula-participa-de-festival-de-musica-no-recife.ghtml.txt
559,-2,-1,soltura-lula,g1,28,1,0,0,22,4,2,1,g1.globo.com___politica_ao-vivo_stf-julgamento-prisao-de-condenados-segunda-instancia.ghtml.txt
560,-5,-3,soltura-lula,g1,147,6,3,2,122,10,5,21,g1.globo.com___politica_blog_gerson-camarotti_post_2019_11_08_em-liberdade-lula-comeca-a-buscar-polarizacao-bolsonaro-deve-resgatar-discurso-antipetista.ghtml.txt
561,7,4,impeachment-dilma,g1,82,0,4,1,64,3,10,10,g1.globo.com___politica_blog_matheus-leitao_post_cardozo-emociona-senadores-pro-impeachment-e-recebe-ligacao-de-dilma.html.txt
562,-3,0,reforma-previdencia,g1,237,2,2,2,175,17,14,37,g1.globo.com___politica_blog_valdo-cruz_post_2019_03_11_pec-do-pacto-federativo-vai-ajudar-a-aprovar-reforma-da-previdencia-avalia-paulo-guedes.ghtml.txt
563,6,14,impeachment-dilma,g1,889,7,21,4,705,41,47,128,g1.globo.com___politica_noticia_2015_12_eduardo-cunha-informa-que-autorizou-processo-de-impeachment-de-dilma.html.txt
564,9,7,impeachment-dilma,g1,581,15,22,5,476,32,41,74,g1.globo.com___politica_noticia_2015_12_leia-integra-da-carta-enviada-pelo-vice-michel-temer-dilma.html.txt
565,-9,-18,impeachment-dilma,g1,675,29,11,3,549,45,36,88,g1.globo.com___politica_noticia_2016_03_por-aclamacao-pmdb-oficializa-rompimento-com-governo-dilma.html.txt
566,7,7,impeachment-dilma,g1,230,4,11,3,179,15,22,32,g1.globo.com___politica_noticia_2016_05_audio-de-juca-deixa-evidente-carater-golpista-do-impeachment-diz-dilma.html.txt
567,16,2,soltura-lula,g1,535,13,15,2,438,33,49,45,g1.globo.com___politica_noticia_2018_12_04_apos-dois-votos-contra-liberdade-de-lula-julgamento-na-2a-turma-do-stf-e-adiado.ghtml.txt
568,18,1,soltura-lula,g1,577,20,21,0,487,29,47,55,g1.globo.com___politica_noticia_2018_12_19_marco-aurelio-mello-determina-soltura-de-todos-os-presos-com-condenacao-apos-2a-instancia.ghtml.txt
569,7,0,reforma-previdencia,g1,278,0,0,0,218,6,13,41,g1.globo.com___politica_noticia_2019_02_14_reforma-da-previdencia-preve-idade-minima-de-65-anos-para-homens-e-62-para-mulheres-diz-secretario.ghtml.txt
570,8,1,reforma-previdencia,g1,306,3,4,1,251,13,21,29,g1.globo.com___politica_noticia_2019_03_23_bolsonaro-e-maia-travam-duelo-de-declaracoes-sobre-votacao-da-previdencia-veja-frases.ghtml.txt
571,-12,-6,reforma-previdencia,g1,865,28,22,13,693,54,42,139,g1.globo.com___politica_noticia_2019_04_03_ccj-da-camara-ouve-paulo-guedes-sobre-reforma-da-previdencia.ghtml.txt
572,7,3,reforma-previdencia,g1,310,3,6,3,242,12,19,49,g1.globo.com___politica_noticia_2019_04_09_bolsonaro-e-maia-dizem-que-nao-gostariam-de-fazer-reforma-da-previdencia-mas-sao-obrigados.ghtml.txt
573,5,4,reforma-previdencia,g1,237,3,7,3,191,13,18,28,g1.globo.com___politica_noticia_2019_04_16_apos-12-horas-ccj-encerra-debate-sobre-previdencia-sessao-sera-retomada-nesta-quarta.ghtml.txt
574,12,7,reforma-previdencia,g1,532,2,9,2,430,22,34,59,g1.globo.com___politica_noticia_2019_04_23_ccj-da-camara-da-aval-a-reforma-da-previdencia-e-texto-segue-para-comissao-especial.ghtml.txt
575,7,3,reforma-previdencia,g1,205,2,5,3,151,12,19,33,g1.globo.com___politica_noticia_2019_04_25_entenda-os-proximos-passos-da-reforma-da-previdencia-na-comissao-especial.ghtml.txt
576,9,2,reforma-previdencia,g1,701,7,9,3,591,23,32,74,g1.globo.com___politica_noticia_2019_06_06_governadores-vao-divulgar-carta-de-repudio-contra-retirada-dos-estados-da-reforma-da-previdencia.ghtml.txt
577,3,-6,soltura-lula,g1,241,10,4,3,196,18,21,23,g1.globo.com___politica_noticia_2019_06_11_lewandowski-vota-para-derrubar-sumula-do-trf-4-que-ordena-prisao-apos-condenacao-em-2a-instancia.ghtml.txt
578,5,5,reforma-previdencia,g1,162,3,8,2,117,10,15,33,g1.globo.com___politica_noticia_2019_06_18_comissao-da-camara-discutira-reforma-previdencia-nesta-terca-saiba-como-sera-a-sessao.ghtml.txt
579,14,8,reforma-previdencia,g1,382,0,8,0,311,10,24,45,g1.globo.com___politica_noticia_2019_07_04_comissao-especial-da-camara-dos-deputados-aprova-texto-base-da-reforma-da-previdencia.ghtml.txt
580,21,11,reforma-previdencia,g1,236,0,11,3,187,7,28,28,g1.globo.com___politica_noticia_2019_07_04_reforma-da-previdencia-veja-as-proximas-etapas-da-tramitacao-apos-a-comissao-especial.ghtml.txt
581,-1,-5,reforma-previdencia,g1,887,13,8,3,712,48,47,104,g1.globo.com___politica_noticia_2019_07_10_camara-aprova-em-primeiro-turno-texto-base-da-pec-da-previdencia.ghtml.txt
582,25,19,reforma-previdencia,g1,810,10,29,8,645,40,65,107,g1.globo.com___politica_noticia_2019_08_07_camara-rejeita-destaques-e-aprova-reforma-da-previdencia-em-2o-turno-texto-vai-ao-senado.ghtml.txt
583,3,2,reforma-previdencia,g1,264,1,3,1,225,6,9,29,g1.globo.com___politica_noticia_2019_08_15_votacao-da-reforma-da-previdencia-no-senado-e-adiada-em-uma-semana.ghtml.txt
584,0,3,reforma-previdencia,g1,452,1,4,0,387,12,12,46,g1.globo.com___politica_noticia_2019_08_20_ccj-do-senado-comeca-debates-sobre-reforma-da-previdencia.ghtml.txt
585,7,0,reforma-previdencia,g1,195,1,1,0,165,5,12,15,g1.globo.com___politica_noticia_2019_09_23_alcolumbre-convoca-sessao-do-congresso-e-adia-reforma-da-previdencia-para-quarta-feira.ghtml.txt
586,10,3,reforma-previdencia,g1,465,1,4,4,394,12,22,46,g1.globo.com___politica_noticia_2019_10_01_reforma-da-previdencia-ccj-aprova-relatorio-e-texto-segue-para-o-plenario-do-senado.ghtml.txt
587,2,-5,soltura-lula,g1,754,36,31,5,608,59,61,98,g1.globo.com___politica_noticia_2019_10_23_relator-no-stf-vota-contra-prisao-apos-condenacao-em-segunda-instancia-e-a-favor-de-liberar-presos.ghtml.txt
588,-6,-12,soltura-lula,g1,933,50,38,9,755,81,75,119,g1.globo.com___politica_noticia_2019_10_23_supremo-suspende-sessao-com-tres-votos-a-um-a-favor-da-prisao-apos-condenacao-em-2a-instancia.ghtml.txt
589,14,10,reforma-previdencia,g1,543,5,15,2,435,22,36,72,g1.globo.com___politica_noticia_2019_11_06_previdencia-senado-aprova-em-1o-turno-texto-base-da-pec-que-inclui-estados-e-municipios-na-reforma.ghtml.txt
590,-2,-37,soltura-lula,g1,793,46,9,1,742,29,27,51,g1.globo.com___politica_noticia_2019_11_09_cidades-tem-manifestacoes-contra-decisao-do-stf-sobre-prisao-apos-condenacao-em-segunda-instancia.ghtml.txt
591,0,-4,soltura-lula,g1,152,7,3,0,142,6,6,8,g1.globo.com___politica_noticia_2019_12_10_pesquisa-datafolha-aponta-que-54percent-consideram-justa-e-42percent-injusta-a-libertacao-de-lula.ghtml.txt
592,4,4,prisao-lula,g1,299,11,15,1,251,18,22,35,g1.globo.com___politica_noticia_ao-stf-dodge-defende-prisao-apos-2-instancia-e-diz-que-revisao-da-medida-poe-em-xeque-seriedade-do-sistema-juridico.ghtml.txt
593,25,10,reforma-trabalhista,g1,807,10,20,10,634,48,73,92,g1.globo.com___politica_noticia_apos-sessao-tumultuada-senado-aprova-texto-base-da-reforma-trabalhista.ghtml.txt
594,-7,-1,afastamento-aecio,g1,539,16,15,1,424,45,38,64,g1.globo.com___politica_noticia_audio-aecio-e-joesley-batista-acertam-pagamento-de-r-2-milhoes.ghtml.txt
595,81,40,reforma-trabalhista,g1,1690,31,71,10,1334,76,157,235,g1.globo.com___politica_noticia_camara-aprova-texto-base-da-reforma-trabalhista.ghtml.txt
596,9,2,afastamento-aecio,g1,260,4,6,2,214,13,22,23,g1.globo.com___politica_noticia_cinco-senadores-assinam-recurso-para-desarquivar-pedido-de-cassacao-de-aecio.ghtml.txt
597,1,2,prisao-lula,g1,103,4,6,0,92,4,5,12,g1.globo.com___politica_noticia_comandante-do-exercito-diz-que-compartilha-anseio-de-repudio-a-impunidade.ghtml.txt
598,-15,-10,afastamento-aecio,g1,489,21,11,5,421,43,28,34,g1.globo.com___politica_noticia_decisao-do-afastamento-do-senador-aecio-neves-veja-perguntas-e-respostas.ghtml.txt
599,-16,-6,prisao-lula,g1,229,16,10,0,203,29,13,10,g1.globo.com___politica_noticia_defesa-de-lula-quer-que-stf-conceda-prisao-domiciliar-se-pedido-de-liberdade-do-ex-presidente-for-rejeitado.ghtml.txt
600,-3,-2,prisao-lula,g1,364,12,10,0,287,33,30,36,g1.globo.com___politica_noticia_defesa-de-lula-recorre-de-decisao-de-fachin-e-pede-ao-stf-a-libertacao-de-ex-presidente.ghtml.txt
601,6,1,prisao-lula,g1,307,8,9,1,249,23,29,24,g1.globo.com___politica_noticia_defesa-faz-novo-pedido-ao-stf-para-tentar-evitar-prisao-de-lula.ghtml.txt
602,10,-3,prisao-lula,g1,238,9,6,1,201,13,23,17,g1.globo.com___politica_noticia_fachin-nega-novo-pedido-de-lula-para-evitar-prisao.ghtml.txt
603,11,10,afastamento-aecio,g1,558,15,25,3,452,33,44,72,g1.globo.com___politica_noticia_grampo-da-pf-mostra-bronca-de-aecio-em-zeze-perrella-por-declaracao.ghtml.txt
604,24,13,reforma-trabalhista,g1,520,7,20,3,399,26,50,75,g1.globo.com___politica_noticia_itens-da-reforma-trabalhista-sao-questionados-em-acoes-no-stf-saiba-quais.ghtml.txt
605,-11,-23,prisao-lula,g1,278,28,5,1,219,29,18,46,g1.globo.com___politica_noticia_luiz-inacio-lula-da-silva-e-primeiro-ex-presidente-brasileiro-preso-por-crime-comum.ghtml.txt
606,16,-31,prisao-lula,g1,878,31,0,0,797,28,44,40,g1.globo.com___politica_noticia_lula-tem-31-bolsonaro-15-marina-10-aponta-pesquisa-datafolha-para-2018.ghtml.txt
607,29,2,prisao-lula,g1,469,17,19,2,401,24,53,29,g1.globo.com___politica_noticia_maioria-do-supremo-decide-julgar-pedido-de-habeas-corpus-preventivo-de-lula-para-evitar-ser-preso.ghtml.txt
608,6,-6,prisao-lula,g1,259,9,3,1,209,16,22,25,g1.globo.com___politica_noticia_marco-aurelio-diz-que-cogita-levar-ao-plenario-decisao-sobre-liminar-para-impedir-prisao-apos-2-instancia.ghtml.txt
609,31,28,reforma-trabalhista,g1,874,9,37,5,709,34,65,117,g1.globo.com___politica_noticia_nova-legislacao-trabalhista-governo-edita-mp-para-fazer-ajustes-na-lei-em-vigor.ghtml.txt
610,3,-5,reforma-trabalhista,g1,221,8,3,6,177,12,15,34,g1.globo.com___politica_noticia_para-maia-reforma-trabalhista-e-timida-e-justica-do-trabalho-nao-deveria-existir.ghtml.txt
611,2,-5,reforma-trabalhista,g1,147,9,4,3,109,12,14,28,g1.globo.com___politica_noticia_pdt-expulsa-deputado-que-votou-a-favor-da-reforma-trabalhista.ghtml.txt
612,-4,4,afastamento-aecio,g1,280,3,7,2,233,19,15,25,g1.globo.com___politica_noticia_pf-apreende-documento-com-inscricao-cx-2-no-apartamento-de-aecio.ghtml.txt
613,1,1,afastamento-aecio,g1,280,5,6,1,228,17,18,29,g1.globo.com___politica_noticia_presidente-do-conselho-de-etica-do-senado-arquiva-representacao-que-pedia-cassacao-de-aecio.ghtml.txt
614,13,6,reforma-trabalhista,g1,409,3,9,2,336,14,27,46,g1.globo.com___politica_noticia_presidente-do-tst-avalia-como-razoavel-intervalo-de-30-minutos-para-almoco.ghtml.txt
615,2,-1,reforma-trabalhista,g1,130,1,0,0,117,1,3,10,g1.globo.com___politica_noticia_saiba-como-cada-senador-votou-sobre-a-reforma-trabalhista.ghtml.txt
616,-1,0,reforma-trabalhista,g1,382,0,0,0,362,6,5,9,g1.globo.com___politica_noticia_saiba-como-votou-cada-deputado-no-texto-base-da-reforma-trabalhista.ghtml.txt
617,0,-4,prisao-lula,g1,237,10,6,2,202,11,11,31,g1.globo.com___politica_noticia_saiba-o-que-pode-acontecer-com-lula-apos-julgamento-de-habeas-corpus-no-stf.ghtml.txt
618,-1,7,afastamento-aecio,g1,247,2,9,3,211,15,14,21,g1.globo.com___politica_noticia_senado-derruba-afastamento-de-aecio.ghtml.txt
619,1,1,afastamento-aecio,g1,1104,32,33,11,903,79,80,118,g1.globo.com___politica_noticia_stf-decide-que-pode-impor-medidas-cautelares-mas-que-aplicacao-sera-submetida-ao-congresso.ghtml.txt
620,1,-48,prisao-lula,g1,1481,84,36,12,1245,102,103,163,g1.globo.com___politica_noticia_stf-julgamento-habeas-corpus-lula-4-de-abril.ghtml.txt
621,7,-6,prisao-lula,g1,254,13,7,2,216,12,19,29,g1.globo.com___politica_noticia_stf-julgara-pedido-para-evitar-prisao-de-lula-nesta-quinta-anuncia-carmen-lucia.ghtml.txt
622,6,8,afastamento-aecio,g1,267,2,10,1,215,10,16,39,g1.globo.com___politica_noticia_stf-levanta-sigilo-e-conversa-de-jornalista-com-irma-de-aecio-e-divulgada.ghtml.txt
623,5,-7,prisao-lula,g1,315,18,11,2,261,22,27,36,g1.globo.com___politica_noticia_superior-tribunal-de-justica-decide-nesta-terca-se-livra-lula-de-ser-preso.ghtml.txt
624,74,32,reforma-trabalhista,g1,1667,15,47,11,1353,57,131,199,g1.globo.com___politica_noticia_veja-principais-pontos-das-reformas-trabalhista-e-da-previdencia.ghtml.txt
625,-6,0,afastamento-aecio,g1,328,6,6,0,281,20,14,25,g1.globo.com___politica_noticia_video-mostra-executivo-da-jf-entregando-dinheiro-a-primo-de-aecio.ghtml.txt
626,-17,-4,afastamento-aecio,g1,549,20,16,4,442,46,29,72,g1.globo.com___politica_operacao-lava-jato_noticia_aecio-diz-que-e-vitima-de-armacao-e-que-nao-ganhou-dinheiro-com-politica.ghtml.txt
627,12,-2,prisao-lula,g1,195,9,7,0,167,6,18,20,g1.globo.com___politica_operacao-lava-jato_noticia_comprador-do-triplex-que-levou-lula-a-prisao-diz-que-fez-investimento-por-simbologia-e-posicao-privilegiada.ghtml.txt
628,15,8,afastamento-aecio,g1,393,5,13,1,339,14,29,30,g1.globo.com___politica_operacao-lava-jato_noticia_em-transcricao-de-audio-da-pf-aecio-pede-ajuda-a-gilmar-mendes-sobre-lei-de-abuso-de-autoridade.ghtml.txt
629,-13,-13,afastamento-aecio,g1,360,16,3,3,288,40,27,27,g1.globo.com___politica_operacao-lava-jato_noticia_primeira-turma-do-stf-julga-nesta-terca-pedido-de-prisao-de-aecio-neves.ghtml.txt
630,0,10,impeachment-dilma,g1,343,3,13,3,254,28,28,52,g1.globo.com___politica_processo-de-impeachment-de-dilma_noticia_2015_12_congresso-entra-em-recesso-e-deixa-analise-de-impeachment-para-fevereiro.html.txt
631,1,0,impeachment-dilma,g1,212,5,5,0,168,11,12,31,g1.globo.com___politica_processo-de-impeachment-de-dilma_noticia_2015_12_dilma-buscara-apoio-de-bases-sociais-e-governadores-contra-impeachment.html.txt
632,10,8,impeachment-dilma,g1,326,3,11,4,235,27,37,45,g1.globo.com___politica_processo-de-impeachment-de-dilma_noticia_2015_12_supremo-muda-rito-do-impeachment-entenda-o-que-acontece-agora.html.txt
633,26,3,impeachment-dilma,g1,775,6,9,3,639,35,61,58,g1.globo.com___politica_processo-de-impeachment-de-dilma_noticia_2016_03_camara-elege-membros-de-comissao-que-analisara-impeachment-de-dilma.html.txt
634,-2,5,impeachment-dilma,g1,277,5,10,3,232,15,13,35,g1.globo.com___politica_processo-de-impeachment-de-dilma_noticia_2016_03_oab-decide-apoiar-processo-de-impeachment-de-dilma-no-congresso.html.txt
635,12,2,impeachment-dilma,g1,368,7,9,5,302,17,29,41,g1.globo.com___politica_processo-de-impeachment-de-dilma_noticia_2016_03_oab-protocola-na-camara-novo-pedido-de-impeachment-de-dilma.html.txt
636,8,7,impeachment-dilma,g1,130,0,7,0,101,8,16,12,g1.globo.com___politica_processo-de-impeachment-de-dilma_noticia_2016_03_stf-divulga-acordao-da-decisao-sobre-rito-de-impeachment.html.txt
637,0,-2,impeachment-dilma,g1,238,6,4,3,192,15,15,29,g1.globo.com___politica_processo-de-impeachment-de-dilma_noticia_2016_04_60-dos-deputados-sao-favoraveis-ao-impeachment-diz-pesquisa-datafolha.html.txt
638,6,5,impeachment-dilma,g1,234,1,6,2,179,12,18,34,g1.globo.com___politica_processo-de-impeachment-de-dilma_noticia_2016_04_ate-senado-decidir-impeachment-congresso-tem-paralisia-diz-cunha.html.txt
639,-1,-4,impeachment-dilma,g1,865,19,15,5,681,51,50,122,g1.globo.com___politica_processo-de-impeachment-de-dilma_noticia_2016_04_camara-aprova-prosseguimento-do-processo-de-impeachment-no-senado.html.txt
640,1,4,impeachment-dilma,g1,342,7,11,4,267,20,21,56,g1.globo.com___politica_processo-de-impeachment-de-dilma_noticia_2016_04_comissao-da-camara-aprova-processo-de-impeachment-de-dilma.html.txt
641,7,-1,impeachment-dilma,g1,382,6,5,4,319,15,22,41,g1.globo.com___politica_processo-de-impeachment-de-dilma_noticia_2016_04_comissao-do-senado-ouve-autores-do-pedido-de-impeachment-de-dilma.html.txt
642,7,2,impeachment-dilma,g1,210,7,9,0,177,7,14,28,g1.globo.com___politica_processo-de-impeachment-de-dilma_noticia_2016_04_dilma-divulga-nas-redes-sociais-pronunciamento-sobre-impeachment.html.txt
643,24,-1,impeachment-dilma,g1,418,15,14,1,322,14,38,74,g1.globo.com___politica_processo-de-impeachment-de-dilma_noticia_2016_04_e-preciso-um-governo-de-salvacao-nacional-afirma-vice-michel-temer.html.txt
644,19,-6,impeachment-dilma,g1,927,36,30,7,734,53,72,141,g1.globo.com___politica_processo-de-impeachment-de-dilma_noticia_2016_04_em-discurso-nos-eua-dilma-deve-dizer-que-e-vitima-de-golpe-no-brasil.html.txt
645,24,1,impeachment-dilma,g1,375,12,13,3,297,19,43,44,g1.globo.com___politica_processo-de-impeachment-de-dilma_noticia_2016_04_ministro-do-stf-manda-cunha-iniciar-analise-do-impeachment-de-temer.html.txt
646,22,22,impeachment-dilma,g1,964,14,36,4,737,48,70,163,g1.globo.com___politica_processo-de-impeachment-de-dilma_noticia_2016_04_relator-jovair-arantes-da-parecer-favoravel-ao-impeachment-de-dilma.html.txt
647,-12,3,impeachment-dilma,g1,224,1,4,0,174,19,7,29,g1.globo.com___politica_processo-de-impeachment-de-dilma_noticia_2016_04_rosso-decide-que-agu-pode-fazer-defesa-de-dilma-no-impeachment.html.txt
648,5,8,impeachment-dilma,g1,430,5,13,5,331,26,31,65,g1.globo.com___politica_processo-de-impeachment-de-dilma_noticia_2016_04_senado-vai-ler-votacao-do-processo-de-impeachment-de-dilma-nesta-terca.html.txt
649,7,12,impeachment-dilma,g1,583,5,17,3,473,30,37,68,g1.globo.com___politica_processo-de-impeachment-de-dilma_noticia_2016_04_senadores-de-pmdb-e-psdb-irao-comandar-comissao-do-impeachment.html.txt
650,-5,-1,impeachment-dilma,g1,1272,4,3,1,1239,13,8,20,g1.globo.com___politica_processo-de-impeachment-de-dilma_noticia_2016_04_veja-ordem-de-votacao-dos-deputados-no-processo-de-impeachment.html.txt
651,16,6,impeachment-dilma,g1,889,18,24,5,710,37,53,136,g1.globo.com___politica_processo-de-impeachment-de-dilma_noticia_2016_04_veja-os-argumentos-pro-e-contra-o-impeachment-de-dilma.html.txt
652,2,0,impeachment-dilma,g1,142,2,2,0,116,4,6,20,g1.globo.com___politica_processo-de-impeachment-de-dilma_noticia_2016_04_vice-temer-acompanha-com-aliados-votacao-da-sessao-do-impeachment.html.txt
653,-5,7,impeachment-dilma,g1,413,6,13,1,343,27,22,41,g1.globo.com___politica_processo-de-impeachment-de-dilma_noticia_2016_05_governo-decide-ir-ao-supremo-para-tentar-anular-impeachment.html.txt
654,7,2,impeachment-dilma,g1,537,8,10,7,432,29,36,65,g1.globo.com___politica_processo-de-impeachment-de-dilma_noticia_2016_05_presidente-em-exercicio-da-camara-anula-votacao-do-impeachment.html.txt
655,3,-1,impeachment-dilma,g1,1000,24,23,7,776,65,68,145,g1.globo.com___politica_processo-de-impeachment-de-dilma_noticia_2016_05_processo-de-impeachment-e-aberto-e-dilma-e-afastada-por-ate-180-dias.html.txt
656,5,11,impeachment-dilma,g1,489,4,15,4,391,21,26,74,g1.globo.com___politica_processo-de-impeachment-de-dilma_noticia_2016_05_senado-prepara-projeto-de-resolucao-sobre-direitos-de-dilma.html.txt
657,6,2,impeachment-dilma,g1,907,30,32,8,751,54,60,112,g1.globo.com___politica_processo-de-impeachment-de-dilma_noticia_2016_08_acusacao-faz-alegacoes-finais-no-julgamento-do-impeachment.html.txt
658,-14,5,impeachment-dilma,g1,392,4,9,5,294,32,18,66,g1.globo.com___politica_processo-de-impeachment-de-dilma_noticia_2016_08_apos-4-horas-anastasia-conclui-leitura-de-relatorio-do-impeachment.html.txt
659,-7,9,impeachment-dilma,g1,653,7,16,0,554,33,26,63,g1.globo.com___politica_processo-de-impeachment-de-dilma_noticia_2016_08_processo-de-impeachment-de-dilma-chega-etapa-final-apos-9-meses.html.txt
660,-1,-2,impeachment-dilma,g1,335,4,2,1,273,16,15,38,g1.globo.com___politica_processo-de-impeachment-de-dilma_noticia_2016_08_procurador-sera-ouvido-como-informante-no-julgamento-de-dilma.html.txt
661,3,3,impeachment-dilma,g1,232,3,6,1,179,12,15,36,g1.globo.com___politica_processo-de-impeachment-de-dilma_noticia_2016_08_renan-calheiros-vota-pelo-impeachment-de-dilma-rousseff.html.txt
662,0,-12,impeachment-dilma,g1,479,21,9,4,398,30,30,55,g1.globo.com___politica_processo-de-impeachment-de-dilma_noticia_2016_08_renan-diz-se-arrepender-da-reacao-que-teve-em-bate-boca-com-gleisi.html.txt
663,-10,9,impeachment-dilma,g1,484,1,10,1,406,28,18,44,g1.globo.com___politica_processo-de-impeachment-de-dilma_noticia_2016_08_saiba-como-sera-o-roteiro-do-julgamento-de-dilma-no-senado.html.txt
664,12,7,impeachment-dilma,g1,624,9,16,3,524,26,38,64,g1.globo.com___politica_processo-de-impeachment-de-dilma_noticia_2016_08_senado-aprova-impeachment-dilma-perde-mandato-e-temer-assume.html.txt
665,-11,3,impeachment-dilma,g1,413,6,9,6,334,28,17,55,g1.globo.com___politica_processo-de-impeachment-de-dilma_noticia_2016_08_senado-ouve-professor-da-uerj-como-informante-da-defesa.html.txt
666,22,6,reforma-previdencia,g1,479,3,9,3,386,13,35,60,g1.globo.com___politica_reforma-da-previdencia_noticia_2019_08_27_relator-entrega-parecer-favoravel-a-aprovacao-da-reforma-da-previdencia-a-presidente-do-senado.ghtml.txt
667,12,-3,reforma-trabalhista,g1,242,5,2,2,191,10,22,28,g1.globo.com___pop-arte_flip_2017_noticia_historiador-defende-cota-racial-e-critica-escravidao-contemporanea-e-reforma-trabalhista.ghtml.txt
668,-4,1,reforma-trabalhista,g1,250,9,10,0,214,16,12,27,g1.globo.com___pr_norte-noroeste_noticia_ministro-da-justica-critica-manifestacoes-e-diz-que-governo-vai-continuar-com-reformas.ghtml.txt
669,-7,-8,soltura-lula,g1,164,12,4,1,141,15,8,17,g1.globo.com___pr_parana_noticia_2019_11_07_lava-jato-diz-que-decisao-do-stf-impactara-resultados-da-forca-tarefa-advogado-afirma-que-pedira-soltura-de-lula.ghtml.txt
670,-2,-10,prisao-lula,g1,189,12,2,2,172,9,7,17,g1.globo.com___pr_parana_noticia_comissao-de-direitos-humanos-do-senado-visita-lula-na-pf-para-verificar-condicoes-da-prisao.ghtml.txt
671,5,-2,prisao-lula,g1,138,9,7,0,121,9,14,10,g1.globo.com___pr_parana_noticia_danny-glover-e-dilma-visitam-lula-na-cela-da-pf-em-curitiba.ghtml.txt
672,-2,0,prisao-lula,g1,136,4,4,1,121,7,5,12,g1.globo.com___pr_parana_noticia_familiares-de-lula-visitam-ex-presidente-na-superintendencia-da-pf-em-curitiba.ghtml.txt
673,-9,-5,afastamento-aecio,g1,332,10,5,0,280,29,20,18,g1.globo.com___pr_parana_noticia_grampo-telefonico-mostra-que-secretario-de-richa-causou-mal-estar-entre-o-governador-e-aecio-neves.ghtml.txt
674,-1,2,prisao-lula,g1,148,2,4,2,122,11,10,13,g1.globo.com___pr_parana_noticia_juiza-autoriza-esteira-ergometrica-e-aparelho-estilo-ipod-a-lula-na-prisao.ghtml.txt
675,0,1,prisao-lula,g1,89,2,3,0,79,5,5,5,g1.globo.com___pr_parana_noticia_pepe-mujica-ex-presidente-do-uruguai-faz-visita-a-lula-na-prisao-em-curitiba.ghtml.txt
676,-1,-7,prisao-lula,g1,175,12,5,1,160,9,8,16,g1.globo.com___pr_parana_noticia_pessoas-com-agendamento-na-pf-em-curitiba-estao-entrando-em-grupos-a-cada-dez-minutos.ghtml.txt
677,2,1,prisao-lula,g1,201,11,12,2,167,12,14,33,g1.globo.com___pr_parana_noticia_sala-especial-em-que-lula-ficara-preso-e-um-direito-previsto-em-lei.ghtml.txt
678,-7,3,prisao-lula,g1,287,8,11,2,233,21,14,40,g1.globo.com___pr_parana_noticia_vaticano-diz-que-terco-que-teria-sido-dado-a-lula-nao-e-presente-do-papa.ghtml.txt
679,3,-2,reforma-trabalhista,g1,131,6,4,1,106,8,11,17,g1.globo.com___rio-de-janeiro_noticia_video-mostra-homem-sendo-agredido-e-expulso-de-protesto-no-rio.ghtml.txt
680,0,0,soltura-lula,g1,21,1,1,0,23,0,0,0,g1.globo.com___rn_rio-grande-do-norte_noticia_2019_11_08_militantes-comemoram-liberdade-de-lula-no-centro-de-natal.ghtml.txt
681,3,-5,reforma-trabalhista,g1,218,5,0,0,188,7,10,18,g1.globo.com___rn_rio-grande-do-norte_noticia_populacao-protesta-contra-reformas-trabalhista-e-da-previdencia-em-natal.ghtml.txt
682,-5,-5,soltura-lula,g1,505,13,8,0,438,25,20,43,g1.globo.com___rs_rio-grande-do-sul_noticia_2019_10_23_mpf-requer-que-sentenca-de-lula-no-processo-do-sitio-de-atibaia-seja-anulada.ghtml.txt
683,2,-5,soltura-lula,g1,159,7,2,0,140,9,11,8,g1.globo.com___rs_rio-grande-do-sul_noticia_2019_11_08_manifestantes-celebram-saida-de-lula-da-prisao-no-centro-de-porto-alegre.ghtml.txt
684,3,-3,prisao-lula,g1,340,11,8,0,289,24,27,19,g1.globo.com___rs_rio-grande-do-sul_noticia_com-lula-preso-defesa-entra-com-ultimo-recurso-no-trf-4-sobre-embargos-negados-no-caso-do-triplex.ghtml.txt
685,1,-2,prisao-lula,g1,706,24,22,4,611,39,40,66,g1.globo.com___rs_rio-grande-do-sul_noticia_presidente-do-trf-4-determina-que-a-decisao-da-soltura-de-lula-volte-para-o-relator-do-processo.ghtml.txt
686,18,-5,reforma-trabalhista,g1,287,10,5,1,238,8,26,31,g1.globo.com___rs_rio-grande-do-sul_noticia_reforma-trabalhista-deve-ser-sancionada-na-quinta-feira-diz-ministro-do-trabalho.ghtml.txt
687,-1,-2,prisao-lula,g1,258,9,7,1,226,17,16,16,g1.globo.com___rs_rio-grande-do-sul_noticia_trf-4-encaminha-oficio-autorizando-prisao-de-lula-a-vara-federal-de-curitiba.ghtml.txt
688,-15,-15,prisao-lula,g1,433,19,4,0,376,36,21,23,g1.globo.com___rs_rio-grande-do-sul_noticia_trf-4-julga-recurso-de-lula-no-caso-triplex-nesta-segunda-feira.ghtml.txt
689,8,6,prisao-lula,g1,629,12,18,3,520,45,53,44,g1.globo.com___rs_rio-grande-do-sul_noticia_trf-4-julga-ultimo-recurso-de-lula-no-caso-do-triplex-do-guaruja.ghtml.txt
690,4,-5,reforma-trabalhista,g1,131,5,0,1,116,2,6,13,g1.globo.com___sao-paulo_noticia_manifestantes-protestam-em-sp-contra-reforma-trabalhista.ghtml.txt
691,-8,-1,reforma-trabalhista,g1,192,1,0,0,171,10,2,10,g1.globo.com___sao-paulo_noticia_sp-tem-paralisacao-de-metro-e-onibus-nesta-quarta-feira.ghtml.txt
692,-6,8,prisao-lula,g1,550,13,21,2,457,33,27,69,g1.globo.com___sp_campinas-regiao_noticia_juiz-federal-de-campinas-suspende-beneficios-do-ex-presidente-lula.ghtml.txt
693,3,-11,prisao-lula,g1,227,14,3,1,207,10,13,15,g1.globo.com___sp_santos-regiao_noticia_manifestantes-ocupam-triplex-atribuido-a-lula-no-guaruja-sp.ghtml.txt
694,8,-5,soltura-lula,g1,424,19,14,2,372,21,29,37,g1.globo.com___sp_sao-paulo_noticia_2019_11_09_lula-chega-a-sao-paulo-apos-ser-solto.ghtml.txt
695,10,11,prisao-lula,g1,369,5,16,2,304,19,29,40,g1.globo.com___sp_sao-paulo_noticia_defesa-de-lula-diz-que-protocolou-recurso-junto-a-comite-da-onu-para-impedir-prisao.ghtml.txt
696,-9,-8,prisao-lula,g1,206,15,7,0,169,23,14,22,g1.globo.com___sp_sao-paulo_noticia_justica-decreta-prisao-de-ex-vereador-e-filho-dele-por-agressao-em-frente-ao-instituto-lula.ghtml.txt
697,-3,-6,prisao-lula,g1,359,13,7,0,307,20,17,35,g1.globo.com___sp_sao-paulo_noticia_manda-esse-lixo-janela-abaixo-audio-durante-voo-de-lula-para-curitiba-entra-na-frequencia-do-aeroporto-de-congonhas.ghtml.txt
698,-2,-3,prisao-lula,g1,170,11,8,0,142,16,14,17,g1.globo.com___sp_sao-paulo_noticia_policia-indicia-ex-vereador-de-diadema-por-agressao-a-empresario-em-frente-ao-instituto-lula.ghtml.txt
699,-1,-7,prisao-lula,g1,222,10,3,0,194,16,15,10,g1.globo.com___sp_sao-paulo_noticia_sp-tem-atos-pro-e-contra-lula-um-dia-antes-de-julgamento-de-habeas-corpus.ghtml.txt
700,4,-5,reforma-trabalhista,g1,472,15,10,0,414,17,21,45,g1.globo.com___to_tocantins_noticia_sindicatos-e-movimentos-sociais-do-to-protestam-contra-reformas.ghtml.txt
701,-4,-1,soltura-lula,estadao,296,10,9,2,255,15,11,36,"internacional.estadao.com.br___noticias_geral,alberto-fernandez-nicolas-maduro-e-bernie-sanders-celebram-libertacao-de-lula,70003082122.txt"
702,16,1,impeachment-dilma,istoe,877,25,26,8,696,55,71,114,istoe.com.br___451082_O+ENSAIO+DO+ADEUS_.txt
703,13,-1,impeachment-dilma,istoe,363,12,11,2,299,15,28,46,istoe.com.br___451654_O+TIME+DE+TEMER_.txt
704,0,-2,impeachment-dilma,istoe,784,32,30,11,622,51,51,133,istoe.com.br___451688_A+PRESIDENTE+MENTE+QUANDO+DIZ+QUE+NAO+HA+CRIME+_.txt
705,6,-7,soltura-lula,istoe,460,21,14,5,385,24,30,61,istoe.com.br___a-hora-do-veredito-final_.txt
706,-1,-5,prisao-lula,istoe,120,5,0,0,108,3,2,12,istoe.com.br___advogados-negociam-para-que-lula-seja-preso-neste-sabado_.txt
707,11,-2,afastamento-aecio,istoe,195,5,3,4,157,7,18,25,istoe.com.br___aecio-diz-que-psdb-permanece-no-governo-mesmo-que-perca-ministerios_.txt
708,3,0,afastamento-aecio,istoe,219,2,2,0,182,8,11,22,istoe.com.br___aecio-neves-retorna-ao-senado-e-discursa-reafirmando-que-e-inocente_.txt
709,2,-1,afastamento-aecio,istoe,173,3,2,0,134,12,14,18,istoe.com.br___aecio-tenta-adiar-decisao-sobre-presidencia-do-psdb-ate-votacao-de-denuncia_.txt
710,-8,-4,afastamento-aecio,istoe,183,10,6,1,151,21,13,15,istoe.com.br___afastamento-de-aecio-sera-julgado-pelo-stf-na-semana-que-vem_.txt
711,0,0,reforma-trabalhista,istoe,0,0,0,0,0,0,0,0,istoe.com.br___afilhados-de-deputados-contrarios-a-reforma-trabalhista-comecam-a-ser-exonerados_.txt
712,-1,1,impeachment-dilma,istoe,248,3,4,0,185,18,17,35,istoe.com.br___aliados-de-dilma-definem-estrategia-para-a-sessao-final-do-impeachment_.txt
713,2,1,soltura-lula,istoe,308,12,13,2,258,19,21,37,istoe.com.br___apos-julgamento-do-stf-parlamentares-pressionam-por-pec-mas-alcolumbre-resiste_.txt
714,9,-5,prisao-lula,istoe,236,11,6,1,195,15,24,20,istoe.com.br___apos-visita-senadores-falam-em-preocupacao-com-isolamento-de-lula_.txt
715,-5,0,soltura-lula,istoe,289,8,8,1,235,23,18,30,istoe.com.br___as-manobras-para-libertar-lula_.txt
716,16,2,reforma-previdencia,istoe,210,1,3,2,157,4,20,35,istoe.com.br___bolsonaro-define-idade-minima-para-dificil-reforma-da-previdencia_.txt
717,1,1,reforma-previdencia,istoe,153,0,1,1,113,6,7,29,istoe.com.br___bolsonaro-discute-reforma-da-previdencia-com-major-vitor-hugo_.txt
718,1,2,reforma-previdencia,istoe,184,2,4,2,152,7,8,25,istoe.com.br___bolsonaro-vai-a-camara-entregar-reforma-da-previdencia-dos-militares_.txt
719,2,2,impeachment-dilma,istoe,320,2,4,4,254,17,19,40,istoe.com.br___calendario-preve-discussao-e-votacao-do-impeachment-no-plenario-em-1o_.txt
720,-2,2,reforma-previdencia,istoe,132,0,2,1,110,6,4,15,istoe.com.br___camara-aprova-texto-base-da-reforma-da-previdencia-em-2o-turno_.txt
721,4,1,reforma-trabalhista,istoe,203,3,4,1,168,3,7,33,istoe.com.br___camara-retoma-discussoes-sobre-reformas-trabalhista-e-da-previdencia_.txt
722,4,2,reforma-previdencia,istoe,191,2,4,1,149,12,16,21,istoe.com.br___ccj-da-camara-deve-votar-hoje-relatorio-da-reforma-da-previdencia_.txt
723,0,-3,soltura-lula,istoe,93,7,4,0,79,6,6,13,istoe.com.br___ciro-gomes-chama-lula-de-enganador-profissional-em-entrevista_.txt
724,4,-7,impeachment-dilma,istoe,351,10,3,4,281,16,20,51,istoe.com.br___clima-fantasmagorico-e-lugubre-invade-gabinete-de-dilma_.txt
725,4,7,reforma-trabalhista,istoe,234,1,8,0,193,8,12,30,istoe.com.br___com-comissoes-funcionando-camara-debate-reformas-trabalhista-e-da-previdencia_.txt
726,1,-12,prisao-lula,istoe,346,17,5,2,272,22,23,53,istoe.com.br___com-lula-preso-o-acontece-agora-no-brasil_.txt
727,0,1,impeachment-dilma,istoe,138,0,1,2,115,6,6,14,istoe.com.br___comeca-no-senado-sessao-de-pronuncia-do-processo-de-impeachment-de-dilma_.txt
728,-1,1,afastamento-aecio,istoe,149,1,2,2,126,10,9,9,istoe.com.br___comeca-processo-de-votacao-sobre-afastamento-de-aecio-neves-do-senado_.txt
729,1,-3,impeachment-dilma,istoe,217,4,1,0,166,12,13,31,istoe.com.br___comissao-do-impeachment-aprova-novo-calendario-dilma-deve-depor-em-6-de-julho_.txt
730,-5,-3,impeachment-dilma,istoe,267,7,4,7,218,15,10,42,istoe.com.br___comissao-do-impeachment-encerra-mais-uma-fase-de-depoimentos-em-defesa-de-dilma_.txt
731,-1,2,impeachment-dilma,istoe,219,1,3,2,166,14,13,32,istoe.com.br___comissao-do-impeachment-vai-conceder-mais-um-dia-de-prazo-para-defesa-de-dilma_.txt
732,0,0,reforma-trabalhista,istoe,0,0,0,0,0,0,0,0,istoe.com.br___comissao-do-senado-aprova-relatorio-da-reforma-trabalhista_.txt
733,6,6,reforma-previdencia,istoe,263,0,6,0,217,4,10,38,istoe.com.br___comissao-encerra-discussao-do-parecer-da-reforma-da-previdencia_.txt
734,-7,1,reforma-previdencia,istoe,181,0,1,0,133,14,7,28,istoe.com.br___comissao-especial-retoma-debate-sobre-reforma-da-previdencia_.txt
735,-3,-13,prisao-lula,istoe,162,15,2,0,141,13,10,15,istoe.com.br___comite-da-onu-rejeita-pedido-do-ex-presidente-lula-contra-sua-prisao_.txt
736,-1,1,reforma-previdencia,istoe,644,4,5,4,531,27,26,73,istoe.com.br___confira-o-que-muda-na-reforma-da-previdencia-com-o-relatorio-de-jereissati_.txt
737,10,-2,reforma-previdencia,istoe,731,11,9,6,577,23,33,124,istoe.com.br___confira-os-pontos-centrais-do-novo-texto-da-reforma-da-previdencia_.txt
738,-5,-28,impeachment-dilma,istoe,401,36,8,6,303,38,33,77,istoe.com.br___crise-politica-continua-no-brasil-apos-impeachment_.txt
739,8,6,impeachment-dilma,istoe,276,6,12,3,212,19,27,39,istoe.com.br___cunha-foi-protagonista-do-impeachment-temer-foi-coadjuvante-diz-dilma_.txt
740,7,-3,impeachment-dilma,istoe,263,6,3,2,196,18,25,35,istoe.com.br___cunha-sobre-afastamento-de-dilma-antes-tarde-do-que-nunca_.txt
741,5,0,impeachment-dilma,istoe,178,1,1,1,153,4,9,15,istoe.com.br___decisao-pelo-impeachment-de-dilma-e-publicada-em-edicao-extra-do-diario-oficial_.txt
742,-2,3,impeachment-dilma,istoe,168,0,3,2,130,10,8,25,istoe.com.br___defensores-do-impeachment-trocam-de-estrategia_.txt
743,-7,-2,afastamento-aecio,istoe,244,4,2,1,195,18,11,27,istoe.com.br___defesa-de-aecio-diz-que-documentos-apreendidos-pela-pf-nao-comprometem-o-senador_.txt
744,-4,10,afastamento-aecio,istoe,297,3,13,4,251,24,20,22,istoe.com.br___defesa-de-aecio-pede-anulacao-de-afastamento-e-novo-relator-no-lugar-de-fachin_.txt
745,4,2,impeachment-dilma,istoe,105,1,3,0,72,12,16,9,istoe.com.br___defesa-de-dilma-entra-com-novo-recurso-para-tentar-anular-impeachment-2_.txt
746,0,0,prisao-lula,istoe,0,0,0,0,0,0,0,0,istoe.com.br___defesa-de-lula-entra-com-habeas-corpus-para-evitar-prisao_.txt
747,1,-4,prisao-lula,istoe,134,9,5,0,125,5,6,12,istoe.com.br___defesa-de-lula-entrega-ao-stf-parecer-contra-prisao-apos-segunda-instancia_.txt
748,0,0,soltura-lula,istoe,0,0,0,0,0,0,0,0,istoe.com.br___defesa-de-lula-protocola-pedido-de-soltura-apos-decisao-do-supremo_.txt
749,0,0,soltura-lula,istoe,0,0,0,0,0,0,0,0,istoe.com.br___defesa-de-lula-vai-apresentar-pedido-de-imediata-soltura-nesta-sexta_.txt
750,3,13,prisao-lula,istoe,257,0,13,6,225,11,14,26,istoe.com.br___desembargador-devolve-beneficios-de-ex-presidente-a-lula_.txt
751,-4,-1,impeachment-dilma,istoe,102,1,0,1,84,5,1,14,istoe.com.br___dilma-confirma-presenca-em-ato-contra-impeachment-em-belo-horizonte_.txt
752,5,2,impeachment-dilma,istoe,260,4,6,3,217,9,14,33,istoe.com.br___dilma-desce-do-carro-e-cumprimenta-manifestantes-ao-deixar-o-alvorada_.txt
753,5,2,impeachment-dilma,istoe,229,5,7,1,182,6,11,43,istoe.com.br___dilma-diz-ser-estranhissima-votacao-separada-do-impeachment_.txt
754,3,5,impeachment-dilma,istoe,214,1,6,1,173,10,13,26,istoe.com.br___dilma-nao-participou-de-pedaladas-diz-diretor-do-mda-na-comissao-do-impeachment_.txt
755,-6,-8,impeachment-dilma,istoe,173,12,4,3,144,17,11,20,istoe.com.br___dilma-se-apresentara-pessoalmente-no-julgamento-do-impeachment_.txt
756,18,-3,impeachment-dilma,istoe,415,12,9,5,320,20,38,63,istoe.com.br___dilma-se-despede-do-palacio-da-alvorada_.txt
757,-12,-13,soltura-lula,istoe,1065,33,20,2,880,73,61,106,istoe.com.br___dinheiro-publico-banca-o-lula-livre_.txt
758,6,2,reforma-previdencia,istoe,338,2,4,0,281,12,18,33,istoe.com.br___dolar-cai-com-otimismo-sobre-reforma-da-previdencia-e-vies-de-baixa-no-exterior_.txt
759,8,0,soltura-lula,istoe,262,6,6,1,225,7,15,28,istoe.com.br___dolar-ganha-ainda-mais-forca-apos-soltura-de-lula-e-fecha-em-alta_.txt
760,5,-1,soltura-lula,istoe,172,3,2,0,135,6,11,25,istoe.com.br___dolar-sobe-com-lula-e-eua-china-no-radar_.txt
761,0,0,soltura-lula,istoe,0,0,0,0,0,0,0,0,istoe.com.br___doria-saida-temporaria-de-lula-da-cadeia-nao-anula-os-crimes-que-cometeu_.txt
762,-1,-5,impeachment-dilma,istoe,157,7,2,0,128,10,9,19,istoe.com.br___em-dialogos-gravados-juca-sugere-que-impeachment-pode-deter-lava-jato_.txt
763,0,0,soltura-lula,istoe,0,0,0,0,0,0,0,0,istoe.com.br___em-discurso-lula-diz-que-nao-pensou-que-poderia-estar-fora-da-cadeia-hoje_.txt
764,4,0,prisao-lula,istoe,154,8,8,1,132,10,14,15,istoe.com.br___em-nova-carta-lula-acusa-moro-de-ignorar-decisao-do-stf_.txt
765,-3,4,soltura-lula,istoe,175,4,8,2,145,14,11,19,istoe.com.br___em-passagem-por-goiania-bolsonaro-ignora-soltura-de-lula_.txt
766,-4,-7,prisao-lula,istoe,137,11,4,1,123,13,9,8,istoe.com.br___em-video-gravado-antes-de-ser-preso-lula-afirma-que-moro-tem-mente-doentia_.txt
767,28,18,reforma-previdencia,istoe,854,3,21,4,695,23,51,113,istoe.com.br___entenda-as-regras-de-transicao-da-reforma-da-previdencia_.txt
768,2,-12,prisao-lula,istoe,330,20,8,7,277,24,26,38,istoe.com.br___estou-pronto-para-ser-preso-diz-lula-em-livro_.txt
769,5,3,soltura-lula,istoe,141,7,10,2,117,6,11,26,istoe.com.br___ex-premier-da-italia-comemora-liberdade-de-lula_.txt
770,6,-4,afastamento-aecio,istoe,287,12,8,2,233,20,26,30,istoe.com.br___expandiu-se-demais-a-investigacao-alem-dos-limites-diz-gilmar_.txt
771,2,-1,prisao-lula,istoe,142,6,5,0,127,6,8,12,istoe.com.br___fachin-autoriza-comissao-de-deputados-a-visitar-lula-na-prisao_.txt
772,11,5,prisao-lula,istoe,209,5,10,1,176,9,20,20,istoe.com.br___fachin-nega-novo-pedido-de-lula-para-evitar-prisao_.txt
773,0,-5,afastamento-aecio,istoe,172,7,2,1,149,12,12,9,istoe.com.br___fachin-pede-pauta-no-plenario-para-acao-sobre-afastamento-de-deputados-do-rio_.txt
774,0,0,afastamento-aecio,istoe,0,0,0,0,0,0,0,0,istoe.com.br___fachin-separa-investigacao-sobre-temer-e-aecio-neves-no-stf_.txt
775,-3,-3,prisao-lula,istoe,104,4,1,0,91,7,4,7,istoe.com.br___familia-faz-primeira-visita-a-lula-na-cadeia_.txt
776,3,-2,soltura-lula,istoe,118,9,7,1,99,8,11,17,istoe.com.br___fas-do-socialismo-corrupto-celebram-soltura-de-lula-diz-araujo-pelo-twitter_.txt
777,0,0,impeachment-dilma,istoe,0,0,0,0,0,0,0,0,istoe.com.br___fhc-fala-de-pedaladas-e-impeachment-de-dilma-em-entrevista-a-al-jazeera_.txt
778,8,1,reforma-previdencia,istoe,198,2,3,2,154,8,16,27,istoe.com.br___fim-da-votacao-de-destaques-a-reforma-da-previdencia-fica-para-amanha_.txt
779,6,-2,prisao-lula,istoe,242,8,6,0,208,13,19,16,istoe.com.br___gilmar-mendes-nega-pedido-de-lula-para-ser-solto_.txt
780,0,1,reforma-trabalhista,istoe,243,5,6,2,188,18,18,32,istoe.com.br___governo-consegue-aprovar-urgencia-para-reforma-trabalhista_.txt
781,6,2,reforma-trabalhista,istoe,101,7,9,1,91,3,9,15,istoe.com.br___governo-vai-ganhar-no-plenario-diz-temer-sobre-reforma-trabalhista_.txt
782,1,-15,impeachment-dilma,istoe,350,18,3,2,272,21,22,58,istoe.com.br___gritos-e-insultos-interrompem-julgamento-do-impeachment-de-dilma_.txt
783,-12,0,impeachment-dilma,istoe,239,10,10,0,204,19,7,29,istoe.com.br___jamais-vou-desistir-de-lutar-afirma-dilma-apos-afastamento_.txt
784,18,2,reforma-trabalhista,istoe,228,4,6,0,177,8,26,27,istoe.com.br___juca-defende-mudancas-na-reforma-trabalhista-via-mp_.txt
785,9,3,reforma-trabalhista,istoe,237,2,5,2,196,10,19,21,istoe.com.br___juca-defende-que-senado-mantenha-texto-da-reforma-trabalhista_.txt
786,0,0,reforma-trabalhista,istoe,0,0,0,0,0,0,0,0,istoe.com.br___juca-garante-mudancas-prometidas-pelo-governo-na-reforma-trabalhista_.txt
787,-3,-7,soltura-lula,istoe,140,9,2,0,131,7,4,9,istoe.com.br___juiz-determina-saida-de-lula-da-prisao_.txt
788,-1,2,prisao-lula,istoe,122,2,4,0,99,8,7,14,istoe.com.br___juiza-nega-visita-de-dilma-rousseff-e-de-deputados-a-lula-na-prisao_.txt
789,-6,2,impeachment-dilma,istoe,186,0,2,0,135,18,12,23,istoe.com.br___lewandowski-rejeita-recurso-de-dilma-para-incluir-audios-de-machado-no-processo_.txt
790,0,0,soltura-lula,istoe,0,0,0,0,0,0,0,0,istoe.com.br___liberdade-de-lula-e-destaque-na-imprensa-internacional_.txt
791,6,-6,reforma-trabalhista,istoe,163,7,1,0,132,6,12,21,istoe.com.br___lider-do-dem-na-camara-defende-que-governo-priorize-reforma-trabalhista_.txt
792,8,2,reforma-trabalhista,istoe,113,1,3,0,88,1,9,19,istoe.com.br___lideres-preveem-votacao-da-reforma-trabalhista-para-segunda-semana-de-julho_.txt
793,0,0,prisao-lula,istoe,0,0,0,0,0,0,0,0,istoe.com.br___lula-chora-e-grava-audio-para-video-que-sera-divulgado-pelo-pt-apos-prisao_.txt
794,-3,-2,soltura-lula,istoe,108,6,4,1,94,7,4,14,istoe.com.br___lula-cita-lado-podre-do-estado-brasileiro-da-justica-do-mp-e-da-pf_.txt
795,-4,-5,soltura-lula,istoe,136,7,2,0,104,12,8,21,istoe.com.br___lula-fora-do-jogo-a-angustia-do-pt_.txt
796,5,3,reforma-trabalhista,istoe,384,2,5,4,308,20,25,42,istoe.com.br___maia-diz-que-pretende-concluir-votacao-de-reforma-trabalhista-ate-quinta_.txt
797,0,0,soltura-lula,istoe,0,0,0,0,0,0,0,0,istoe.com.br___maioria-considera-soltura-de-lula-justa-apos-decisao-do-stf-segundo-pesquisa-datafolha_.txt
798,-6,-2,prisao-lula,istoe,175,4,2,2,151,15,9,8,istoe.com.br___maioria-da-5a-turma-do-stj-vota-contra-pedido-de-lula-para-evitar-prisao_.txt
799,0,0,reforma-trabalhista,istoe,0,0,0,0,0,0,0,0,istoe.com.br___manifestantes-protestam-contra-reforma-trabalhista_.txt
800,-1,-4,afastamento-aecio,istoe,308,9,5,2,254,20,19,31,istoe.com.br___marco-aurelio-admite-revisao-de-afastamento-de-aecio-pelo-senado_.txt
801,-1,0,soltura-lula,istoe,125,4,4,0,109,9,8,7,istoe.com.br___marco-aurelio-mello-determina-soltura-de-todos-os-presos-com-condenacao-apos-2a-instancia_.txt
802,0,0,reforma-trabalhista,istoe,0,0,0,0,0,0,0,0,istoe.com.br___meirelles-nova-era-em-relacoes-de-trabalho-trara-mais-produtividade-e-empregos_.txt
803,4,3,reforma-trabalhista,istoe,93,0,3,1,75,4,8,10,istoe.com.br___meirelles-preve-apresentacao-da-proposta-da-reforma-tributaria-no-2o-semestre_.txt
804,-2,0,reforma-trabalhista,istoe,118,1,1,0,98,6,4,12,istoe.com.br___meirelles-previsao-e-reforma-trabalhista-previdencia-e-tributaria-em-seguida_.txt
805,10,0,reforma-trabalhista,istoe,116,3,3,1,90,5,15,13,istoe.com.br___meirelles-urgencia-da-reforma-trabalhista-e-fato-foco-agora-e-previdencia_.txt
806,-3,-7,prisao-lula,istoe,249,10,3,1,204,22,19,18,istoe.com.br___mesmo-com-rejeicao-de-habeas-corpus-inicio-da-prisao-de-lula-ainda-nao-tem-data_.txt
807,-1,5,prisao-lula,istoe,456,13,18,3,384,26,25,55,istoe.com.br___milhares-pedem-nas-ruas-a-prisao-de-lula-na-vespera-da-sessao-do-stf_.txt
808,4,10,reforma-trabalhista,istoe,130,1,11,1,102,8,12,21,istoe.com.br___ministro-diz-que-reforma-trabalhista-pode-tirar-45-milhoes-da-informalidade_.txt
809,0,0,prisao-lula,istoe,0,0,0,0,0,0,0,0,istoe.com.br___ministro-do-stj-nega-mais-um-recurso-de-lula-para-deixar-prisao_.txt
810,0,0,impeachment-dilma,istoe,0,0,0,0,0,0,0,0,istoe.com.br___moodys-impeachment-de-dilma-nao-altera-visao-sobre-perspectivas-de-credito_.txt
811,16,-6,reforma-trabalhista,istoe,260,8,2,1,198,11,27,35,istoe.com.br___mp-da-reforma-trabalhista-ja-recebeu-882-emendas-e-bate-recorde-do-congresso_.txt
812,3,-1,reforma-trabalhista,istoe,145,3,2,0,115,7,10,18,istoe.com.br___mp-que-altera-reforma-trabalhista-deve-sair-em-outubro-diz-presidente-da-ugt_.txt
813,1,2,prisao-lula,istoe,106,4,6,0,90,5,6,15,istoe.com.br___mujica-visitou-lula-na-prisao-e-o-viu-com-bom-animo_.txt
814,0,-2,impeachment-dilma,istoe,117,2,0,0,99,4,4,12,istoe.com.br___na-vespera-da-votacao-do-impeachment-temer-recebe-senador_.txt
815,0,2,reforma-trabalhista,istoe,125,2,4,2,105,7,7,14,istoe.com.br___nao-ha-acordo-para-texto-da-reforma-trabalhista-voltar-para-camara-diz-padilha_.txt
816,-2,1,reforma-previdencia,istoe,304,2,3,5,241,17,15,41,istoe.com.br___no-senado-comeca-reuniao-da-ccj-para-discutir-e-votar-previdencia_.txt
817,12,-14,soltura-lula,istoe,1348,61,47,10,1110,88,100,168,istoe.com.br___o-brasil-quer-justica_.txt
818,6,-7,impeachment-dilma,istoe,400,13,6,2,350,14,20,37,istoe.com.br___o-caminho-ate-o-impeachment-de-dilma_.txt
819,9,-20,reforma-previdencia,istoe,1003,39,19,6,773,68,77,149,istoe.com.br___o-presidente-quer-enterrar-a-previdencia_.txt
820,-18,-42,prisao-lula,istoe,1014,58,16,16,833,84,66,121,istoe.com.br___o-pt-sem-lula_.txt
821,14,-4,afastamento-aecio,istoe,296,12,8,3,232,19,33,35,istoe.com.br___oab-deve-protocolar-pedido-de-afastamento-de-temer-ate-quinta-feira_.txt
822,3,1,afastamento-aecio,istoe,463,4,5,2,385,17,20,52,istoe.com.br___odebrecht-pagava-tribo-e-barbudos-da-cut-na-floresta_.txt
823,3,-5,prisao-lula,istoe,146,6,1,0,128,5,8,12,istoe.com.br___oscar-maroni-tem-casa-invadida-por-integrantes-do-mtst-empresario-comemorou-prisao-de-lula_.txt
824,11,-9,afastamento-aecio,istoe,282,18,9,1,236,17,28,29,istoe.com.br___parecer-da-agu-e-contra-afastamento-de-parlamentares_.txt
825,-4,0,reforma-previdencia,istoe,229,3,3,0,182,15,11,27,istoe.com.br___paulo-guedes-vai-a-camara-para-debater-reforma-da-previdencia_.txt
826,-5,-4,prisao-lula,istoe,207,9,5,1,178,15,10,19,istoe.com.br___pedido-de-liberdade-de-lula-sera-julgado-no-dia-26-pelo-stf_.txt
827,13,-8,impeachment-dilma,istoe,196,13,5,3,156,11,24,26,istoe.com.br___pesquisa-mostra-temer-melhor-do-que-dilma_.txt
828,5,2,reforma-previdencia,istoe,118,0,2,1,104,3,8,6,istoe.com.br___plenario-do-senado-aprova-em-primeiro-turno-texto-da-reforma-da-previdencia_.txt
829,4,-3,prisao-lula,istoe,288,12,9,0,246,17,21,25,istoe.com.br___podera-haver-reducao-da-pena-de-lula-no-stj-ou-no-stf-diz-gilmar-mendes-em-sp_.txt
830,3,-8,soltura-lula,istoe,491,31,23,5,404,33,36,77,istoe.com.br___politicos-comentam-nas-redes-sociais-soltura-de-lula-e-prisao-em-2a-instancia_.txt
831,22,4,reforma-trabalhista,istoe,263,4,8,2,199,7,29,42,istoe.com.br___presidente-da-camara-garante-que-aprovacao-da-reforma-trabalhista-sera-em-abril_.txt
832,5,0,prisao-lula,istoe,119,3,3,0,102,5,10,8,istoe.com.br___presidente-do-tribunal-da-lava-jato-mantem-lula-preso_.txt
833,-3,1,soltura-lula,istoe,101,4,5,1,90,5,2,14,istoe.com.br___presidente-eleito-da-argentina-sauda-lula-livre-e-elogia-sua-fortaleza_.txt
834,-5,-7,prisao-lula,istoe,167,11,4,0,124,22,17,19,istoe.com.br___prisao-de-lula-nao-vai-ser-aceita-com-normalidade-diz-gleisi-hoffmann_.txt
835,3,-19,impeachment-dilma,istoe,363,21,2,0,284,30,33,39,istoe.com.br___prisao-de-paulo-bernardo-enfraquece-dilma-na-comissao-do-impeachment_.txt
836,-11,4,afastamento-aecio,istoe,244,4,8,1,215,19,8,15,istoe.com.br___procuradoria-apura-se-pagamento-de-publicidade-ocultou-doacao-a-aecio_.txt
837,7,-8,afastamento-aecio,istoe,195,11,3,0,163,10,17,19,istoe.com.br___psdb-decide-manter-aecio-neves-afastado-da-presidencia-do-partido-e-mantem-tasso_.txt
838,8,-13,afastamento-aecio,istoe,315,15,2,1,245,22,30,36,istoe.com.br___psdb-e-dem-vao-esperar-o-supremo-para-decidir-apoio-a-temer_.txt
839,7,-5,reforma-trabalhista,istoe,184,8,3,0,154,8,15,18,istoe.com.br___psdb-quer-relatorio-unico-para-as-3-comissoes-da-reforma-trabalhista-no-senado_.txt
840,-12,-13,prisao-lula,istoe,104,14,1,0,91,16,4,8,istoe.com.br___pt-avalia-mudanca-de-sede-para-cutitiba-enquanto-lula-estiver-preso_.txt
841,0,0,prisao-lula,istoe,0,0,0,0,0,0,0,0,istoe.com.br___pt-faz-reuniao-para-discutir-atuacao-dos-deputados-na-camara-apos-prisao-de-lula_.txt
842,-9,-6,prisao-lula,istoe,265,13,7,0,224,23,14,24,istoe.com.br___pt-ve-possibilidade-de-prisao-de-lula-antes-da-pascoa_.txt
843,6,-1,prisao-lula,istoe,310,11,10,0,269,17,23,22,istoe.com.br___recurso-de-lula-contra-a-prisao-comeca-a-ser-julgado-virtualmente_.txt
844,-2,0,afastamento-aecio,istoe,124,0,0,1,103,6,4,12,istoe.com.br___rede-recorre-do-arquivamento-do-pedido-de-cassacao-de-aecio-neves_.txt
845,8,2,reforma-previdencia,istoe,178,1,3,0,151,6,14,11,istoe.com.br___reforma-da-previdencia-interessa-ate-para-o-servidor-diz-bolsonaro_.txt
846,-2,0,reforma-previdencia,istoe,288,7,7,2,222,20,18,44,istoe.com.br___reforma-da-previdencia-vitoria-de-rodrigo-maia-e-derrota-da-esquerda_.txt
847,10,5,reforma-trabalhista,istoe,187,0,5,0,147,4,14,27,istoe.com.br___reforma-trabalhista-deve-ser-votada-na-camara-ate-o-fim-de-abril-diz-relator_.txt
848,17,7,reforma-trabalhista,istoe,148,0,7,1,114,1,18,23,istoe.com.br___reforma-trabalhista-preve-demissao-de-comum-acordo-entre-trabalhador-e-empresa_.txt
849,28,12,reforma-trabalhista,istoe,428,3,15,5,332,16,44,59,istoe.com.br___reforma-trabalhista-veja-ponto-a-ponto-como-ficou-a-lei-aprovada-pelo-congresso_.txt
850,0,0,impeachment-dilma,istoe,0,0,0,0,0,0,0,0,istoe.com.br___relator-apresenta-nessa-terca-parecer-sobre-impeachment-de-dilma-rousseff_.txt
851,1,3,reforma-trabalhista,istoe,166,1,4,1,117,14,15,26,istoe.com.br___relator-defende-debate-da-reforma-trabalhista-pelo-plenario-da-camara_.txt
852,3,2,impeachment-dilma,istoe,121,1,3,0,97,4,7,17,istoe.com.br___renan-dilma-ira-colaborar-para-que-calendario-do-impeachment-seja-cumprido_.txt
853,-5,-8,reforma-trabalhista,istoe,193,11,3,1,155,16,11,26,istoe.com.br___renan-e-juca-divergem-sobre-reforma-trabalhista_.txt
854,0,0,reforma-trabalhista,istoe,0,0,0,0,0,0,0,0,istoe.com.br___renan-recebe-centrais-sindicais-e-oposicao-para-debater-reforma-trabalhista_.txt
855,5,3,afastamento-aecio,istoe,333,5,8,1,265,26,31,25,istoe.com.br___representacao-contra-aecio-no-senado-aguarda-formacao-do-conselho-de-etica_.txt
856,-3,0,impeachment-dilma,istoe,172,0,0,0,143,6,3,20,istoe.com.br___revelacoes-de-odebrecht-ajudam-a-consolidar-impeachment-de-dilma-diz-eunicio_.txt
857,0,0,prisao-lula,istoe,0,0,0,0,0,0,0,0,istoe.com.br___rojoes-sao-disparados-por-todo-o-brasil-apos-prisao-de-lula_.txt
858,4,-1,afastamento-aecio,istoe,112,4,3,2,87,7,11,16,istoe.com.br___senado-adia-votacao-sobre-afastamento-de-aecio_.txt
859,0,0,reforma-trabalhista,istoe,0,0,0,0,0,0,0,0,istoe.com.br___senado-aprova-urgencia-de-reforma-trabalhista_.txt
860,4,-4,impeachment-dilma,istoe,232,8,4,1,196,13,17,19,istoe.com.br___senado-instaura-processo-de-impeachment-e-dilma-e-afastada-da-presidencia_.txt
861,-1,-3,impeachment-dilma,istoe,191,7,4,1,155,15,14,19,istoe.com.br___senadores-que-apoiam-impeachment-discutem-estrategias-para-o-depoimento-de-dilma_.txt
862,-1,1,reforma-previdencia,istoe,313,3,4,1,254,17,16,34,istoe.com.br___servidor-quer-barrar-reforma-na-ccj_.txt
863,-3,-5,soltura-lula,istoe,200,5,0,0,170,15,12,8,istoe.com.br___stf-adia-julgamento-de-habeas-corpus-de-lula_.txt
864,3,-4,prisao-lula,istoe,187,7,3,1,165,6,9,18,istoe.com.br___stf-adia-julgamento-mas-da-liminar-contra-prisao-de-lula_.txt
865,-2,3,afastamento-aecio,istoe,201,2,5,0,172,8,6,22,istoe.com.br___stf-divulga-conversa-do-jornalista-reinaldo-azevedo-com-irma-de-aecio_.txt
866,2,0,impeachment-dilma,istoe,102,4,4,0,90,5,7,8,istoe.com.br___stf-nega-liminar-para-anular-sessao-do-senado-que-aprovou-impeachment-de-dilma_.txt
867,-2,-6,soltura-lula,istoe,344,16,10,0,287,23,21,39,istoe.com.br___stf-retoma-debate-que-pode-libertar-lula_.txt
868,-1,-9,soltura-lula,istoe,322,14,5,2,264,20,19,40,istoe.com.br___stf-retoma-julgamento-da-2a-instancia_.txt
869,2,-1,prisao-lula,istoe,144,5,4,0,129,5,7,12,istoe.com.br___stj-recebe-mais-260-habeas-corpus-em-favor-de-lula_.txt
870,2,0,afastamento-aecio,istoe,147,1,1,2,122,4,6,19,istoe.com.br___suplente-se-diz-triste-por-ter-afinidade-com-aecio_.txt
871,0,-4,afastamento-aecio,istoe,114,4,0,1,90,10,10,9,istoe.com.br___supremo-adia-decisao-sobre-prisao-do-senador-afastado-aecio-neves_.txt
872,5,3,impeachment-dilma,istoe,228,1,4,1,175,12,17,30,istoe.com.br___temer-assume-presidencia-e-lewandowski-assume-processo-de-impeachment_.txt
873,-4,-2,impeachment-dilma,istoe,112,2,0,3,87,10,6,14,istoe.com.br___temer-e-notificado-de-decisao-do-senado-sobre-impeachment-de-dilma_.txt
874,15,0,reforma-trabalhista,istoe,255,8,8,0,194,8,23,46,istoe.com.br___temer-e-renan-avancam-em-entendimento-sobre-a-reforma-trabalhista_.txt
875,16,6,reforma-trabalhista,istoe,225,5,11,1,167,8,24,43,istoe.com.br___temer-pede-mesmo-grau-de-engajamento-no-senado-para-reforma-trabalhista_.txt
876,2,-6,reforma-trabalhista,istoe,191,9,3,2,151,16,18,20,istoe.com.br___temer-reconhece-que-ha-excessos-na-reforma-trabalhista-afirma-renan_.txt
877,2,0,reforma-trabalhista,istoe,93,3,3,0,78,2,4,15,istoe.com.br___temer-reforma-trabalhista-trara-inumeras-vantagens-a-quem-nao-tinha-direitos_.txt
878,7,0,impeachment-dilma,istoe,135,4,4,0,115,6,13,9,istoe.com.br___teori-ainda-nao-decidiu-sobre-pedido-da-agu-contra-impeachment_.txt
879,-5,10,impeachment-dilma,istoe,412,5,15,0,325,36,31,40,istoe.com.br___teori-nega-mais-um-pedido-de-dilma-para-anular-julgamento-do-impeachment_.txt
880,-3,-3,afastamento-aecio,istoe,161,9,6,2,138,16,13,11,istoe.com.br___torcer-pela-prisao-de-aecio-e-equivoco-diz-lider-do-pt-na-camara_.txt
881,0,0,soltura-lula,istoe,0,0,0,0,0,0,0,0,istoe.com.br___turma-do-stf-decide-julgar-pedido-de-soltura-de-lula_.txt
882,19,-16,prisao-lula,istoe,1121,50,34,17,927,75,94,126,istoe.com.br___um-partido-transformado-em-seita_.txt
883,6,6,reforma-previdencia,istoe,263,2,8,1,204,12,18,40,istoe.com.br___vamos-jogar-pesado-na-reforma-da-previdencia-diz-bolsonaro_.txt
884,-5,1,impeachment-dilma,istoe,133,3,4,1,104,13,8,16,istoe.com.br___waldir-maranhao-revoga-ato-em-que-anulou-sessao-do-impeachment-na-camara_.txt
885,-7,-8,afastamento-aecio,istoe,207,10,2,2,170,18,11,22,istoedinheiro.com.br___aecio-afasta-tasso-da-presidencia-do-psdb-e-reassume-cargo-no-partido_.txt
886,5,-2,afastamento-aecio,istoe,140,3,1,0,104,7,12,21,istoedinheiro.com.br___alckmin-defende-que-psdb-fique-no-governo-e-propoe-antecipar-substituto-de-aecio_.txt
887,5,-2,afastamento-aecio,istoe,167,5,3,1,128,11,16,21,istoedinheiro.com.br___aliados-no-psdb-reagem-a-acao-para-destituir-tucano_.txt
888,30,5,reforma-trabalhista,istoe,460,6,11,2,351,18,48,62,istoedinheiro.com.br___com-flexibilizacao-de-varios-pontos-da-clt-reforma-trabalhista-divide-opinioes_.txt
889,-2,1,reforma-trabalhista,istoe,263,4,5,3,215,16,14,30,istoedinheiro.com.br___comissao-do-senado-volta-a-discutir-reforma-trabalhista-acompanhe-ao-vivo_.txt
890,1,4,afastamento-aecio,istoe,192,1,5,2,161,10,11,18,istoedinheiro.com.br___conselho-de-etica-do-senado-arquiva-processo-contra-aecio-neves_.txt
891,7,6,afastamento-aecio,istoe,190,1,7,0,151,8,15,24,istoedinheiro.com.br___conselho-de-etica-do-senado-deve-decidir-futuro-de-aecio-neves-em-novembro_.txt
892,-5,-2,afastamento-aecio,istoe,121,3,1,0,98,13,8,6,istoedinheiro.com.br___defesa-de-aecio-volta-a-pedir-julgamento-no-plenario-do-stf-em-vez-da-1a-turma_.txt
893,0,0,soltura-lula,istoe,0,0,0,0,0,0,0,0,istoedinheiro.com.br___defesa-de-lula-protocola-pedido-de-soltura-do-ex-presidente-da-republica_.txt
894,7,3,reforma-trabalhista,istoe,306,1,4,0,228,12,19,52,istoedinheiro.com.br___domesticos-podem-ficar-fora-da-reforma-trabalhista_.txt
895,-5,-8,afastamento-aecio,istoe,140,9,1,0,102,18,13,17,istoedinheiro.com.br___doria-defende-permanencia-do-psdb-no-governo-temer_.txt
896,35,4,reforma-trabalhista,istoe,356,9,13,1,277,12,47,43,istoedinheiro.com.br___duvidas-cercam-reforma-trabalhista_.txt
897,5,7,reforma-trabalhista,istoe,290,1,8,1,218,19,24,39,istoedinheiro.com.br___em-pronunciamento-ministro-diz-que-reforma-trabalhista-consolida-direitos_.txt
898,15,5,reforma-trabalhista,istoe,357,1,6,2,291,8,23,44,istoedinheiro.com.br___entenda-quais-principais-mudancas-na-reforma-trabalhista-proposta-pelo-governo_.txt
899,-2,0,afastamento-aecio,istoe,121,4,4,0,107,8,6,8,istoedinheiro.com.br___janot-volta-a-pedir-ao-stf-a-prisao-de-aecio-neves_.txt
900,2,3,afastamento-aecio,istoe,127,1,4,1,108,7,9,9,istoedinheiro.com.br___lewandowski-e-sorteado-relator-de-um-dos-inqueritos-contra-aecio-neves-no-stf_.txt
901,4,-3,reforma-previdencia,istoe,220,5,2,3,164,12,16,38,istoedinheiro.com.br___maia-cobra-participacao-de-bolsonaro-em-esforco-pela-reforma-da-previdencia_.txt
902,-11,-2,afastamento-aecio,istoe,111,3,1,0,85,18,7,5,istoedinheiro.com.br___marco-aurelio-diz-que-so-vai-analisar-denuncia-de-aecio-apos-julgar-recursos_.txt
903,3,0,afastamento-aecio,istoe,398,10,10,3,325,26,29,41,istoedinheiro.com.br___marco-aurelio-permite-que-aecio-volte-ao-senado_.txt
904,12,-4,reforma-trabalhista,istoe,194,6,2,0,156,3,15,28,istoedinheiro.com.br___milhares-tomam-a-paulista-contra-reformas-trabalhistas-e-da-previdencia_.txt
905,0,0,reforma-trabalhista,istoe,0,0,0,0,0,0,0,0,istoedinheiro.com.br___ministro-do-trabalho-ira-ao-senado-discutir-reforma-trabalhista-com-relatores_.txt
906,5,1,reforma-trabalhista,istoe,107,2,3,0,87,2,7,16,istoedinheiro.com.br___ministros-reassumem-pastas-apos-votacao-da-reforma-trabalhista_.txt
907,4,-2,impeachment-dilma,istoe,203,9,7,1,155,14,18,33,istoedinheiro.com.br___noticias_economia_20151202_eduardo-cunha-aceita-pedido-impeachment-contra-dilma_322650.txt
908,-3,2,impeachment-dilma,istoe,191,2,4,3,149,12,9,30,istoedinheiro.com.br___noticias_economia_20160226_tenho-consciencia-tranquila-diz-dilma-jornal-chileno-sobre-impeachment_346918.txt
909,-9,3,impeachment-dilma,istoe,305,4,7,1,246,18,9,44,istoedinheiro.com.br___noticias_economia_20160410_seguranca-maxima-brasilia-por-votacao-impeachment-dilma_360944.txt
910,0,0,impeachment-dilma,istoe,0,0,0,0,0,0,0,0,istoedinheiro.com.br___noticias_economia_20160411_comissao-parlamentar-recomenda-abertura-processo-impeachment_361386.txt
911,3,-4,impeachment-dilma,istoe,422,11,7,3,336,25,28,54,istoedinheiro.com.br___noticias_economia_20160415_brasil-debate-impeachment-dilma-sessao-dramatica-congresso_362942.txt
912,3,-2,impeachment-dilma,istoe,146,3,1,2,120,5,8,19,istoedinheiro.com.br___noticias_economia_20160503_comissao-especial-rejeita-arquivar-processo-impeachment-dilma_368721.txt
913,-6,-1,impeachment-dilma,istoe,211,4,3,1,180,12,6,21,istoedinheiro.com.br___noticias_economia_20160505_inicio-processo-impeachment-foi-chantagem-cunha-diz-dilma_369697.txt
914,0,0,impeachment-dilma,istoe,0,0,0,0,0,0,0,0,istoedinheiro.com.br___noticias_economia_20160706_cardozo-lera-depoimento-pessoal-dilma-comissao-impeachment_390466.txt
915,9,7,reforma-trabalhista,istoe,267,1,8,1,206,13,22,36,istoedinheiro.com.br___oposicao-tenta-mudar-reforma-trabalhista_.txt
916,-4,-1,reforma-trabalhista,istoe,293,10,9,3,254,19,15,27,istoedinheiro.com.br___partidos-registram-traicoes-ao-governo-na-votacao-da-reforma-trabalhista_.txt
917,-4,-3,afastamento-aecio,istoe,96,3,0,4,77,7,3,16,istoedinheiro.com.br___presidente-da-alesp-defende-renuncia-de-aecio-a-presidencia-do-psdb_.txt
918,0,-6,afastamento-aecio,istoe,124,6,0,0,100,10,10,10,istoedinheiro.com.br___psdb-de-sao-paulo-pressiona-cupula-por-desembarque-do-governo-temer_.txt
919,18,-5,reforma-trabalhista,istoe,228,6,1,2,167,11,29,30,istoedinheiro.com.br___reforma-trabalhista-amplia-horizontes-para-quem-procura-emprego-diz-temer_.txt
920,8,-5,reforma-trabalhista,istoe,270,9,4,4,220,13,21,33,istoedinheiro.com.br___reforma-trabalhista-pode-sofrer-seis-alteracoes_.txt
921,2,-2,reforma-trabalhista,istoe,214,3,1,1,161,12,14,32,istoedinheiro.com.br___relatorio-da-reforma-trabalhista-fica-pronto-neste-mes_.txt
922,11,2,reforma-trabalhista,istoe,172,1,3,1,143,2,13,19,istoedinheiro.com.br___renan-critica-reforma-trabalhista-enquanto-base-da-camara-tenta-vitoria_.txt
923,1,3,reforma-trabalhista,istoe,260,5,8,1,209,14,15,36,istoedinheiro.com.br___temer-e-ministros-fazem-balanco-da-reforma-trabalhista-diz-aguinaldo_.txt
924,0,0,reforma-trabalhista,istoe,0,0,0,0,0,0,0,0,istoedinheiro.com.br___toffoli-nega-pedido-do-pcdob-para-suspender-votacao-da-reforma-trabalhista_.txt
925,4,-2,reforma-trabalhista,folha,229,10,8,2,177,15,19,38,m.folha.uol.com.br___mercado_2017_04_1879081-pdt-expulsa-deputado-que-votou-a-favor-de-reforma-trabalhista.shtml.txt
926,23,-16,impeachment-dilma,folha,579,25,9,4,488,23,46,60,m.folha.uol.com.br___poder_2015_12_1716221-temer-escreve-carta-em-tom-de-desabafo-a-dilma.shtml.txt
927,2,-1,impeachment-dilma,folha,397,3,2,1,324,18,20,41,m.folha.uol.com.br___poder_2016_03_1747562-stf-conclui-publicacao-de-decisao-sobre-rito-do-impeachment.shtml.txt
928,0,4,impeachment-dilma,folha,170,0,4,0,150,5,5,14,m.folha.uol.com.br___poder_2016_03_1751005-juiz-que-suspendeu-posse-de-lula-e-favoravel-a-protestos-contra-dilma.shtml.txt
929,7,2,impeachment-dilma,folha,286,3,5,2,240,13,20,23,m.folha.uol.com.br___poder_2016_03_1751745-oab-declara-apoio-ao-impeachment-da-presidente-dilma.shtml.txt
930,8,1,impeachment-dilma,folha,395,6,7,3,333,17,25,36,m.folha.uol.com.br___poder_2016_03_1751953-fhc-passa-a-defender-impeachment-de-dilma.shtml.txt
931,-16,7,impeachment-dilma,folha,380,1,8,4,307,34,18,34,m.folha.uol.com.br___poder_2016_08_1802169-advogado-de-dilma-entrega-ultimo-documento-da-defesa-e-questiona-erros.shtml.txt
932,-4,-1,afastamento-aecio,oglobo,299,5,4,0,244,19,15,30,oglobo.globo.com___brasil_advogado-da-jbs-diz-que-revisao-seria-golpe-de-morte-nas-delacoes-21503384.txt
933,-2,-23,afastamento-aecio,oglobo,399,26,3,2,319,32,30,49,oglobo.globo.com___brasil_aecio-neves-destitui-tasso-jereissati-da-presidencia-do-psdb-22049673.txt
934,33,7,afastamento-aecio,oglobo,584,10,17,3,456,28,61,69,oglobo.globo.com___brasil_aecio-recorreu-amigo-para-tentar-interferir-em-recall-da-andrade-gutierrez-1-21418331.txt
935,-2,5,prisao-lula,oglobo,357,4,9,1,290,27,25,29,oglobo.globo.com___brasil_alexandre-de-moraes-nega-pedido-de-liberdade-de-lula-22836379.txt
936,6,3,soltura-lula,oglobo,125,3,6,0,103,6,12,13,oglobo.globo.com___brasil_apos-decisao-do-stf-sobre-2-instancia-bolsonaro-ignora-lula-diz-que-nao-vai-entrar-em-canoa-furada-1-24071590.txt
937,5,-1,soltura-lula,oglobo,375,10,9,2,326,15,20,35,oglobo.globo.com___brasil_apos-justica-determinar-soltura-de-lula-bolsonaro-mantem-silencio-24070798.txt
938,10,-21,impeachment-dilma,oglobo,628,42,21,3,499,54,64,77,oglobo.globo.com___brasil_audio-de-temer-pos-impeachment-repercute-no-congresso-19060303.txt
939,27,0,impeachment-dilma,oglobo,798,12,12,9,656,35,62,78,oglobo.globo.com___brasil_camara-aprova-processo-de-impeachment-de-dilma-que-segue-para-senado-19109151.txt
940,1,1,impeachment-dilma,oglobo,267,4,5,2,219,17,18,24,oglobo.globo.com___brasil_cardozo-diz-que-vai-recorrer-ao-stf-caso-senado-confirme-impeachment-19618027.txt
941,-5,3,prisao-lula,oglobo,313,12,15,1,270,18,13,40,oglobo.globo.com___brasil_ciro-diz-que-brasil-nao-tera-paz-enquanto-lula-estiver-preso-22903201.txt
942,-17,-14,impeachment-dilma,oglobo,597,28,14,6,488,51,34,72,oglobo.globo.com___brasil_comissao-do-senado-aprova-relatorio-favoravel-ao-julgamento-de-dilma-19852029.txt
943,12,2,impeachment-dilma,oglobo,306,9,11,4,243,17,29,41,oglobo.globo.com___brasil_comissao-especial-aprova-parecer-pelo-impeachment-da-presidente-dilma-19062038.txt
944,3,-4,prisao-lula,oglobo,351,10,6,2,283,24,27,35,oglobo.globo.com___brasil_comite-da-onu-rejeita-recursos-da-defesa-contra-prisao-de-lula-22705542.txt
945,3,1,impeachment-dilma,oglobo,73,0,1,0,66,1,4,3,oglobo.globo.com___brasil_confira-como-votou-cada-senador-da-comissao-do-impeachment-19247118.txt
946,21,5,impeachment-dilma,oglobo,882,9,14,10,696,46,67,106,oglobo.globo.com___brasil_continuidade-do-processo-de-impeachment-tem-maioria-no-senado-19875256.txt
947,-3,-1,impeachment-dilma,oglobo,115,2,1,1,94,9,6,10,oglobo.globo.com___brasil_datafolha-60-dos-deputados-afirmam-votar-pelo-impeachment-19042448.txt
948,-5,-10,impeachment-dilma,oglobo,756,21,11,10,605,51,46,96,oglobo.globo.com___brasil_debandada-de-partidos-amplia-isolamento-de-dilma-19072919.txt
949,3,0,prisao-lula,oglobo,149,8,8,1,123,9,12,22,oglobo.globo.com___brasil_defesa-de-lula-cobra-julgamento-do-stf-para-prisao-em-segunda-instancia-22461655.txt
950,-3,5,soltura-lula,oglobo,230,3,8,1,193,17,14,18,oglobo.globo.com___brasil_defesa-de-lula-entra-com-pedido-de-liberdade-48-minutos-apos-decisao-de-marco-aurelio-23316625.txt
951,0,-2,prisao-lula,oglobo,208,8,6,2,177,12,12,23,oglobo.globo.com___brasil_defesa-de-lula-recorre-ao-stf-para-reverter-prisao-de-ex-presidente-22588799.txt
952,2,-4,soltura-lula,oglobo,146,7,3,1,110,14,16,17,oglobo.globo.com___brasil_defesa-pedira-soltura-imediata-de-lula-que-dependera-de-aval-de-juiza-de-curitiba-24068918.txt
953,7,-3,prisao-lula,oglobo,373,9,6,7,318,11,18,48,oglobo.globo.com___brasil_deltan-diz-que-fara-jejum-durante-julgamento-de-hc-de-lula-22548453.txt
954,10,1,impeachment-dilma,oglobo,538,13,14,4,438,26,36,69,oglobo.globo.com___brasil_dilma-afastada-da-presidencia-por-55-votos-favor-22-contra-19286831.txt
955,-1,-4,impeachment-dilma,oglobo,435,14,10,1,362,21,20,57,oglobo.globo.com___brasil_dilma-cancela-pronunciamento-em-cadeia-nacional-de-radio-tv-19095850.txt
956,7,4,impeachment-dilma,oglobo,311,7,11,0,260,12,19,38,oglobo.globo.com___brasil_dilma-desiste-de-descer-rampa-com-mulheres-apos-impeachment-19271032.txt
957,-2,-11,afastamento-aecio,oglobo,323,19,8,2,272,23,21,36,oglobo.globo.com___brasil_dilma-diz-que-historia-foi-severa-implacavel-com-temer-aecio-cunha-21559021.txt
958,-6,2,impeachment-dilma,oglobo,247,8,10,1,209,20,14,23,oglobo.globo.com___brasil_dilma-diz-que-impeachment-foi-golpe-parlamentar-um-ato-misogino-19812751.txt
959,11,2,impeachment-dilma,oglobo,752,37,39,7,602,44,55,134,oglobo.globo.com___brasil_dilma-senado-tomou-decisao-que-entra-para-historia-das-grandes-injusticas-20026652.txt
960,1,-24,impeachment-dilma,oglobo,637,30,6,2,510,41,42,82,oglobo.globo.com___brasil_dilma-temer-disputam-voto-voto-na-vespera-da-decisao-sobre-impeachment-na-camara-19104782.txt
961,3,-6,impeachment-dilma,oglobo,291,10,4,3,231,17,20,40,oglobo.globo.com___brasil_dilma-temer-tem-disputa-apertada-de-votos-no-senado-sobre-impeachment-19412456.txt
962,-13,14,impeachment-dilma,oglobo,704,3,17,3,554,42,29,102,oglobo.globo.com___brasil_dilma-vai-ao-senado-no-dia-29-fazer-sua-propria-defesa-em-julgamento-do-impeachment-19940543.txt
963,-6,-6,impeachment-dilma,oglobo,353,11,5,4,287,24,18,44,oglobo.globo.com___brasil_dois-senadores-ja-admitem-rever-voto-pelo-impeachment-19404106.txt
964,-3,-5,soltura-lula,oglobo,236,14,9,0,219,16,13,11,oglobo.globo.com___brasil_eduardo-azeredo-jose-dirceu-saem-da-prisao-apos-decisao-do-stf-24070849.txt
965,1,5,impeachment-dilma,oglobo,212,7,12,3,170,18,19,27,oglobo.globo.com___brasil_em-documento-enviado-ao-stf-dilma-reitera-que-impeachment-foi-golpe-19461960.txt
966,9,-10,soltura-lula,oglobo,275,14,4,2,225,16,25,29,oglobo.globo.com___brasil_em-salvador-lula-defende-que-pt-nao-precisa-fazer-autocritica-24081180.txt
967,14,-5,impeachment-dilma,oglobo,535,17,12,2,437,22,36,71,oglobo.globo.com___brasil_em-sessao-tumultuada-lideres-partidarios-defendem-voto-contra-a-favor-do-impeachment-19107459.txt
968,2,-2,soltura-lula,oglobo,212,13,11,4,189,12,14,25,oglobo.globo.com___brasil_em-video-nas-redes-lula-diz-que-esta-solto-para-ajudar-libertar-brasil-dessa-loucura-1-24072210.txt
969,-2,8,impeachment-dilma,oglobo,390,4,12,2,319,20,18,51,oglobo.globo.com___brasil_embaixadores-defendem-impeachment-de-dilma-19774701.txt
970,4,-10,prisao-lula,oglobo,198,14,4,3,154,19,23,23,oglobo.globo.com___brasil_estou-pronto-para-ser-preso-diz-lula-em-entrevista-para-livro-22485251.txt
971,-1,-6,afastamento-aecio,oglobo,135,7,1,1,122,5,4,13,oglobo.globo.com___brasil_eu-votei-no-aecio-usuarios-fazem-piada-com-apoiadores-de-tucano-21357297.txt
972,6,-10,afastamento-aecio,oglobo,342,16,6,2,272,26,32,36,oglobo.globo.com___brasil_fachin-divide-inquerito-de-temer-aecio-em-dois-21413916.txt
973,17,6,afastamento-aecio,oglobo,360,3,9,4,288,18,35,35,oglobo.globo.com___brasil_fachin-envia-para-carmen-pedido-de-aecio-sobre-relatoria-de-acao-21899930.txt
974,1,-8,prisao-lula,oglobo,121,10,2,2,103,5,6,21,oglobo.globo.com___brasil_gleisi-pede-apoio-do-mundo-arabe-para-libertar-lula-da-prisao-22604118.txt
975,-3,-5,prisao-lula,oglobo,167,7,2,0,147,8,5,16,oglobo.globo.com___brasil_governadores-do-nordeste-devem-visitar-lula-na-prisao-nesta-terca-feira-22572100.txt
976,1,-6,impeachment-dilma,oglobo,234,9,3,8,189,17,18,30,oglobo.globo.com___brasil_governo-temer-avalia-que-discurso-de-dilma-nao-muda-placar-do-impeachment-20011750.txt
977,-6,-3,impeachment-dilma,oglobo,450,11,8,4,360,31,25,57,oglobo.globo.com___brasil_gravacao-de-juca-escancara-golpe-diz-dilma-19364536.txt
978,4,6,impeachment-dilma,oglobo,243,4,10,3,194,15,19,32,oglobo.globo.com___brasil_grupos-pro-impeachment-sao-contra-muro-para-divisao-da-esplanada-19058444.txt
979,0,0,prisao-lula,oglobo,0,0,0,0,0,0,0,0,oglobo.globo.com___brasil_homem-hospitalizado-apos-ser-agredido-na-porta-do-instituto-lula-22562026.txt
980,14,-9,afastamento-aecio,oglobo,501,16,7,1,438,16,30,41,oglobo.globo.com___brasil_irma-de-aecio-pediu-para-jbs-comprar-cobertura-duplex-de-40-milhoes-21406145.txt
981,4,-2,impeachment-dilma,oglobo,308,9,7,3,256,20,24,27,oglobo.globo.com___brasil_janaina-chora-pede-desculpas-dilma-mas-diz-que-nao-podia-se-omitir-20017303.txt
982,-16,-16,impeachment-dilma,oglobo,198,24,8,2,158,29,13,32,oglobo.globo.com___brasil_jean-wyllys-admite-que-cuspiu-na-cara-de-bolsonaro-19110700.txt
983,-1,1,prisao-lula,oglobo,316,7,8,1,269,17,16,30,oglobo.globo.com___brasil_juiza-barra-visita-de-governadores-lula-22576520.txt
984,-1,4,soltura-lula,oglobo,195,0,4,0,167,11,10,11,oglobo.globo.com___brasil_juiza-pede-manifestacao-do-mpf-sobre-pedido-de-soltura-de-lula-23317400.txt
985,-11,1,prisao-lula,oglobo,411,14,15,1,353,33,22,33,oglobo.globo.com___brasil_juiza-proibe-lula-de-gravar-videos-fazer-pre-campanha-na-prisao-22876249.txt
986,-5,0,impeachment-dilma,oglobo,340,7,7,1,257,25,20,53,oglobo.globo.com___brasil_julgamento-do-impeachment-encerra-fase-de-testemunhas-dilma-apresenta-defesa-na-2-feira-20007040.txt
987,1,0,impeachment-dilma,oglobo,106,5,5,2,91,6,7,14,oglobo.globo.com___brasil_lewandowski-sobre-impeachment-um-tropeco-na-democracia-20197033.txt
988,1,-12,prisao-lula,oglobo,261,14,2,3,224,14,15,27,oglobo.globo.com___brasil_lula-deixa-sede-do-sindicato-pe-se-entrega-pf-22568744.txt
989,-2,0,prisao-lula,oglobo,185,6,6,0,162,11,9,15,oglobo.globo.com___brasil_lula-esta-bem-tentou-nos-animar-diz-senadora-que-visitou-ex-presidente-22601391.txt
990,-11,-6,prisao-lula,oglobo,274,10,4,1,225,21,10,33,oglobo.globo.com___brasil_lula-so-tem-chance-de-sair-da-prisao-se-gente-assumir-poder-diz-ciro-22916212.txt
991,-3,0,soltura-lula,oglobo,98,5,5,0,89,5,2,12,oglobo.globo.com___brasil_maior-presente-para-lula-ganhar-eleicao-tira-lo-da-prisao-diz-gleisi-23192182.txt
992,9,-9,impeachment-dilma,oglobo,263,10,1,4,229,11,20,18,oglobo.globo.com___brasil_maioria-da-populacao-quer-dilma-temer-fora-do-governo-diz-datafolha-19053277.txt
993,-7,-12,prisao-lula,oglobo,240,14,2,1,217,15,8,17,oglobo.globo.com___brasil_manifestantes-fazem-atos-contra-lula-em-23-estados-no-df-22553578.txt
994,1,-4,prisao-lula,oglobo,267,11,7,0,228,18,19,20,oglobo.globo.com___brasil_marco-aurelio-redistribui-novo-pedido-de-habeas-corpus-em-prol-de-lula-no-stf-22564411.txt
995,-10,-4,impeachment-dilma,oglobo,262,9,5,0,222,18,8,28,oglobo.globo.com___brasil_marido-de-deputada-que-votou-pelo-impeachment-prefeito-preso-pela-pf-19113829.txt
996,-1,-3,afastamento-aecio,oglobo,182,6,3,5,152,13,12,19,oglobo.globo.com___brasil_meu-filho-esta-preso-por-lealdade-voce-diz-pai-de-frederico-pacheco-para-aecio-neves-21374445.txt
997,-8,8,impeachment-dilma,oglobo,287,2,10,0,231,20,12,36,oglobo.globo.com___brasil_ministra-do-stf-nega-seis-liminares-contra-fatiamento-do-impeachment-20073408.txt
998,3,-14,prisao-lula,oglobo,457,28,14,0,375,39,42,43,oglobo.globo.com___brasil_ministro-do-stj-nega-pedido-de-lula-para-evitar-prisao-22565563.txt
999,-4,-2,impeachment-dilma,oglobo,298,13,11,2,237,27,23,37,oglobo.globo.com___brasil_ministros-do-stf-dizem-que-impeachment-de-dilma-na-camara-nao-foi-golpe-19134087.txt
1000,0,1,prisao-lula,oglobo,376,8,9,1,330,17,17,30,oglobo.globo.com___brasil_moro-interrompe-ferias-para-despachar-sobre-liberdade-de-lula-22865241.txt
1001,-7,4,prisao-lula,oglobo,289,3,7,0,255,16,9,19,oglobo.globo.com___brasil_moro-pede-esclarecimentos-sobre-ganhos-de-empresa-de-lula-22641073.txt
1002,-1,-8,prisao-lula,oglobo,242,10,2,1,215,10,9,21,oglobo.globo.com___brasil_mtst-termina-invasao-do-triplex-no-guaruja-apos-negociacao-com-pm-22594842.txt
1003,5,-6,soltura-lula,oglobo,211,10,4,8,180,7,12,34,oglobo.globo.com___brasil_nao-quero-ficar-falando-mal-de-presidente-falando-mal-de-ministro-diz-lula-24071570.txt
1004,12,1,soltura-lula,oglobo,385,12,13,0,286,27,39,58,oglobo.globo.com___brasil_nao-temos-um-mandela-neste-pais-preciso-lucidez-diz-boris-fausto-24072820.txt
1005,2,-3,impeachment-dilma,oglobo,166,5,2,0,142,7,9,15,oglobo.globo.com___brasil_no-dia-de-votacao-do-impeachment-dilma-anda-de-bicicleta-mas-reduz-percurso-19106150.txt
1006,3,0,prisao-lula,oglobo,184,8,8,3,155,16,19,13,oglobo.globo.com___brasil_nos-eua-ciro-gomes-diz-que-esta-aflito-com-prisao-de-lula-22565031.txt
1007,4,-2,soltura-lula,oglobo,62,3,1,0,51,3,7,5,oglobo.globo.com___brasil_os-planos-de-lula-ex-presidente-quer-viajar-pelo-brasil-reorganizar-oposicao-ao-governo-1-24069254.txt
1008,18,6,impeachment-dilma,oglobo,401,6,12,3,340,14,32,36,oglobo.globo.com___brasil_pedalada-de-dilma-no-plano-safra-nao-foi-operacao-de-credito-nem-crime-diz-mpf-19712360.txt
1009,-10,-8,soltura-lula,oglobo,519,16,8,7,432,31,21,66,oglobo.globo.com___brasil_pela-primeira-vez-no-rio-apos-soltura-lula-retoma-serie-de-criticas-bolsonaro-reforca-intencao-de-unir-esquerda-1-24147030.txt
1010,10,-5,afastamento-aecio,oglobo,421,11,6,2,354,23,33,30,oglobo.globo.com___brasil_perguntas-respostas-sobre-situacao-de-aecio-neves-21474824.txt
1011,1,-14,prisao-lula,oglobo,276,21,7,1,232,23,24,26,oglobo.globo.com___brasil_petistas-ja-consideram-que-prisao-de-lula-inevitavel-22502788.txt
1012,-1,-5,afastamento-aecio,oglobo,169,6,1,0,153,4,3,16,oglobo.globo.com___brasil_pf-apreende-2-milhoes-em-busca-em-enderecos-de-aecio-aliados-de-temer-21358948.txt
1013,0,2,afastamento-aecio,oglobo,225,3,5,2,189,11,11,24,oglobo.globo.com___brasil_pf-apreende-na-casa-de-aecio-anotacoes-identificadas-como-cx-2-21399432.txt
1014,-6,-2,prisao-lula,oglobo,134,4,2,0,112,13,7,8,oglobo.globo.com___brasil_pf-pede-justica-transferencia-de-lula-por-conta-de-despesas-22622248.txt
1015,3,3,impeachment-dilma,oglobo,203,2,5,1,169,9,12,21,oglobo.globo.com___brasil_pgr-defende-em-parecer-validade-do-processo-de-impeachment-20061707.txt
1016,4,-2,afastamento-aecio,oglobo,223,5,3,0,193,7,11,20,oglobo.globo.com___brasil_policia-federal-flagra-primo-de-aecio-recebendo-propina-da-jbs-21460714.txt
1017,6,-4,soltura-lula,oglobo,191,6,2,0,149,8,14,28,oglobo.globo.com___brasil_politicos-especialistas-avaliam-caminhos-no-debate-politico-fora-da-polarizacao-lula-bolsonaro-24085109.txt
1018,7,-3,impeachment-dilma,oglobo,351,7,4,3,291,11,18,45,oglobo.globo.com___brasil_por-61-votos-20-dilma-afastada-definitivamente-da-presidencia-20025502.txt
1019,6,-8,afastamento-aecio,oglobo,323,9,1,2,264,14,20,37,oglobo.globo.com___brasil_predio-tancredo-neves-volta-cena-com-buscas-em-apartamento-de-andrea-neves-21404463.txt
1020,4,-12,prisao-lula,oglobo,395,31,19,3,339,29,33,47,oglobo.globo.com___brasil_presidenciaveis-comentam-ordem-de-prisao-contra-lula-22562047.txt
1021,-5,7,impeachment-dilma,oglobo,786,12,19,3,625,59,54,82,oglobo.globo.com___brasil_presidente-interino-da-camara-anula-votacao-do-impeachment-de-dilma-19261917.txt
1022,-3,-3,prisao-lula,oglobo,235,7,4,1,189,13,10,35,oglobo.globo.com___brasil_preso-lula-continua-impedir-uniao-entre-partidos-de-esquerda-22592630.txt
1023,6,18,prisao-lula,oglobo,458,11,29,2,379,27,33,61,oglobo.globo.com___brasil_preso-lula-perde-direito-seguranca-motorista-assessores-1-22690853.txt
1024,1,-10,prisao-lula,oglobo,444,18,8,4,389,23,24,38,oglobo.globo.com___brasil_primeiro-dia-de-lula-na-cadeia-tem-cafe-da-manha-simples-quentinha-22569584.txt
1025,-7,-9,soltura-lula,oglobo,126,11,2,1,102,14,7,17,oglobo.globo.com___brasil_prisao-em-2-instancia-toffoli-diz-que-libertacao-nao-automatica-que-congresso-pode-mudar-regra-1-24069070.txt
1026,17,1,impeachment-dilma,oglobo,700,11,12,2,554,35,52,84,oglobo.globo.com___brasil_procurador-do-tcu-diz-que-dilma-cometeu-contabilidade-destrutiva-fraude-fiscal-19209979.txt
1027,11,-7,impeachment-dilma,oglobo,354,10,3,2,298,10,21,40,oglobo.globo.com___brasil_protestos-contra-a-favor-de-dilma-tomam-as-ruas-em-20-estados-19820363.txt
1028,-13,-12,reforma-trabalhista,oglobo,273,22,10,5,215,32,19,44,oglobo.globo.com___brasil_psb-pode-fechar-questao-contra-reformas-romper-com-temer-21250110.txt
1029,3,3,prisao-lula,oglobo,153,2,5,1,131,4,7,19,oglobo.globo.com___brasil_pt-estuda-promover-atos-pro-lula-na-vespera-do-julgamento-no-stf-22521859.txt
1030,7,-9,prisao-lula,oglobo,206,14,5,1,181,9,16,20,oglobo.globo.com___brasil_pt-mantem-aposta-no-stf-para-reverter-prisao-de-lula-22573117.txt
1031,-2,-8,prisao-lula,oglobo,103,10,2,4,82,11,9,17,oglobo.globo.com___brasil_pt-pdt-psol-pcdob-dizem-que-prisao-de-lula-perseguicao-politica-22596516.txt
1032,-9,-2,afastamento-aecio,oglobo,212,5,3,3,175,17,8,23,oglobo.globo.com___brasil_raptado-da-maternidade-em-1986-pedrinho-advogado-de-aecio-neves-21413232.txt
1033,-7,-5,impeachment-dilma,oglobo,168,6,1,0,141,12,5,17,oglobo.globo.com___brasil_recursos-do-impeachment-podem-trazer-dilma-de-volta-diz-janaina-20039652.txt
1034,10,5,afastamento-aecio,oglobo,265,3,8,5,212,7,17,45,oglobo.globo.com___brasil_reinaldo-azevedo-pede-demissao-da-veja-apos-divulgacao-de-grampo-com-irma-de-aecio-sem-indicio-de-crime-21383556.txt
1035,1,-2,afastamento-aecio,oglobo,240,5,3,1,202,12,13,22,oglobo.globo.com___brasil_rocha-loures-devolve-os-35-mil-que-faltavam-da-mala-da-propina-21392707.txt
1036,-6,-12,prisao-lula,oglobo,196,19,7,3,169,19,13,24,oglobo.globo.com___brasil_se-lula-nao-se-entregar-pf-esta-pronta-para-cumprir-mandado-de-prisao-ate-18h-22564108.txt
1037,-16,-7,soltura-lula,oglobo,600,21,14,1,473,54,38,71,oglobo.globo.com___brasil_segunda-instancia-cnj-aponta-que-ate-4895-pessoas-podem-ser-beneficiadas-1-24021382.txt
1038,-7,-1,afastamento-aecio,oglobo,220,10,9,1,184,22,15,19,oglobo.globo.com___brasil_senado-ameaca-nao-cumprir-decisao-da-justica-sobre-aecio-21948307.txt
1039,11,7,impeachment-dilma,oglobo,447,6,13,6,348,24,35,65,oglobo.globo.com___brasil_senado-decide-que-dilma-podera-exercer-cargos-publicos-apos-impeachment-20025723.txt
1040,18,-1,impeachment-dilma,oglobo,343,8,7,1,284,11,29,35,oglobo.globo.com___brasil_senado-elege-os-21-membros-da-comissao-especial-de-impeachment-19161501.txt
1041,7,0,impeachment-dilma,oglobo,296,3,3,2,243,11,18,32,oglobo.globo.com___brasil_senadores-se-confrontam-no-julgamento-do-impeachment-mas-em-intervalo-fazem-piadas-20015553.txt
1042,5,-2,afastamento-aecio,oglobo,466,10,8,1,388,27,32,38,oglobo.globo.com___brasil_stf-afasta-aecio-do-mandato-impoe-recolhimento-noturno-21873990.txt
1043,-3,-5,afastamento-aecio,oglobo,212,12,7,1,189,13,10,20,oglobo.globo.com___brasil_stf-manda-irma-de-aecio-neves-para-prisao-domiciliar-21498906.txt
1044,6,9,impeachment-dilma,oglobo,378,3,12,0,305,17,23,48,oglobo.globo.com___brasil_stf-rejeita-por-8-votos-2-barrar-processo-do-impeachment-19090113.txt
1045,6,1,prisao-lula,oglobo,506,17,18,2,438,29,35,41,oglobo.globo.com___brasil_supremo-decide-destino-de-lula-nesta-quarta-feira-22554385.txt
1046,-2,-11,prisao-lula,oglobo,453,19,8,8,383,28,26,51,oglobo.globo.com___brasil_supremo-rejeita-habeas-corpus-permite-que-lula-seja-preso-22556318.txt
1047,15,-18,impeachment-dilma,oglobo,399,27,9,3,330,24,39,45,oglobo.globo.com___brasil_temer-critica-dilma-por-associar-impeachment-golpe-19141009.txt
1048,5,-3,impeachment-dilma,oglobo,162,7,4,1,137,8,13,16,oglobo.globo.com___brasil_temer-rejeitado-por-grupos-pro-contra-dilma-diz-datafolha-19115223.txt
1049,17,-16,impeachment-dilma,oglobo,457,19,3,4,369,20,37,57,oglobo.globo.com___brasil_temer-toma-posse-como-presidente-da-republica-20027112.txt
1050,8,6,prisao-lula,oglobo,185,3,9,3,160,5,13,22,oglobo.globo.com___brasil_tribunal-restabelece-direito-seguranca-motorista-assessores-ao-ex-presidente-lula-22729634.txt
1051,-1,-8,prisao-lula,oglobo,221,13,5,2,192,8,7,34,oglobo.globo.com___brasil_vaza-audio-de-voo-com-lula-para-curitiba-leva-nao-traz-nunca-mais-22570705.txt
1052,4,1,prisao-lula,oglobo,175,3,4,1,140,7,11,25,oglobo.globo.com___brasil_visita-de-advogado-lula-nao-foi-em-nome-do-papa-diz-vaticano-22769772.txt
1053,7,5,impeachment-dilma,oglobo,173,2,7,1,126,11,18,28,oglobo.globo.com___brasil_waldir-maranhao-vai-seguir-com-pedido-de-impeachment-de-temer-afirma-aliado-de-dilma-19246355.txt
1054,15,15,reforma-trabalhista,oglobo,358,5,20,2,290,20,35,40,oglobo.globo.com___economia_a-um-mes-de-entrar-em-vigor-reforma-trabalhista-ainda-gera-incertezas-21934412.txt
1055,0,-7,reforma-trabalhista,oglobo,200,9,2,2,138,22,22,31,oglobo.globo.com___economia_base-governista-cogita-pedido-de-urgencia-para-levar-proposta-de-reforma-trabalhista-direto-plenario-21312915.txt
1056,-1,0,reforma-trabalhista,oglobo,236,2,2,2,195,12,11,24,oglobo.globo.com___economia_cas-encerra-sessao-de-leitura-do-parecer-da-reforma-trabalhista-21474533.txt
1057,15,6,reforma-trabalhista,oglobo,429,8,14,3,347,20,35,52,oglobo.globo.com___economia_cercado-de-ministros-temer-sanciona-lei-da-reforma-trabalhista-21587695.txt
1058,21,13,reforma-previdencia,oglobo,1434,5,18,5,1147,57,78,180,oglobo.globo.com___economia_comeca-sessao-para-votar-reforma-da-previdencia-entenda-como-sua-aposentadoria-vai-mudar-23795108.txt
1059,8,-1,reforma-trabalhista,oglobo,382,5,4,1,307,16,24,45,oglobo.globo.com___economia_comissao-do-senado-aprova-texto-base-da-reforma-trabalhista-21443391.txt
1060,-3,-1,reforma-trabalhista,oglobo,106,3,2,1,75,9,6,22,oglobo.globo.com___economia_congresso-precisa-aprovar-reforma-trabalhista-diz-setubal-21515544.txt
1061,1,4,reforma-previdencia,oglobo,427,3,7,3,329,18,19,74,oglobo.globo.com___economia_contrapartida-reduz-ganhos-na-reforma-da-previdencia-dos-militares-para-9-bi-23535769.txt
1062,-1,1,reforma-trabalhista,oglobo,93,1,2,1,79,4,3,11,oglobo.globo.com___economia_cunha-lima-articula-acordo-para-colocar-reforma-trabalhista-tambem-na-ccj-21289147.txt
1063,10,2,reforma-trabalhista,oglobo,132,3,5,1,97,6,16,22,oglobo.globo.com___economia_diretor-da-oit-no-brasil-critica-pressa-na-tramitacao-da-reforma-trabalhista-21319718.txt
1064,-9,-8,soltura-lula,oglobo,491,14,6,5,397,32,23,64,oglobo.globo.com___economia_dolar-salta-encerra-cotado-r-416-com-libertacao-de-lula-bolsa-recua-18-24069591.txt
1065,9,2,reforma-trabalhista,oglobo,376,4,6,0,304,18,27,37,oglobo.globo.com___economia_em-mp-governo-cria-quarentena-de-18-meses-para-trabalho-interminente-22070735.txt
1066,3,0,reforma-trabalhista,oglobo,189,5,5,0,156,10,13,20,oglobo.globo.com___economia_entenda-os-18-pontos-centrais-da-reforma-trabalhista-21280368.txt
1067,15,7,reforma-trabalhista,oglobo,638,14,21,4,484,34,49,110,oglobo.globo.com___economia_estudo-preve-potencial-para-reforma-trabalhista-criar-23-milhoes-de-vagas-21496158.txt
1068,4,-2,reforma-trabalhista,oglobo,199,7,5,2,172,6,10,25,oglobo.globo.com___economia_exoneracao-de-ministros-ocorreu-para-tirar-suplentes-que-votariam-contra-reforma-trabalhista-21261448.txt
1069,18,8,reforma-trabalhista,oglobo,597,7,15,2,477,28,46,70,oglobo.globo.com___economia_governo-aprova-urgencia-para-reforma-trabalhista-21553326.txt
1070,12,7,reforma-trabalhista,oglobo,544,7,14,3,441,26,38,63,oglobo.globo.com___economia_governo-comeca-ultima-etapa-para-votacao-de-reforma-trabalhista-21575818.txt
1071,2,-4,reforma-trabalhista,oglobo,134,7,3,2,105,11,13,17,oglobo.globo.com___economia_governo-considera-derrota-na-reforma-trabalhista-superavel-mas-quer-dr-21226227.txt
1072,6,0,reforma-trabalhista,oglobo,239,4,4,3,186,10,16,38,oglobo.globo.com___economia_itamaraty-convoca-embaixador-do-uruguai-para-explicar-declaracoes-contra-reforma-trabalhista-21705603.txt
1073,4,-7,reforma-trabalhista,oglobo,155,10,3,1,124,12,16,17,oglobo.globo.com___economia_juca-nao-descarta-votacao-da-reforma-trabalhista-esta-semana-mas-ainda-busca-acordo-21548427.txt
1074,8,1,reforma-trabalhista,oglobo,235,4,5,1,175,13,21,36,oglobo.globo.com___economia_lider-do-governo-discute-com-centrais-tramitacao-de-reforma-trabalhista-no-senado-21316451.txt
1075,0,-2,reforma-trabalhista,oglobo,135,2,0,0,116,4,4,13,oglobo.globo.com___economia_ministerio-publico-do-trabalho-pede-que-reforma-nao-seja-votada-21576752.txt
1076,3,1,reforma-trabalhista,oglobo,113,0,1,0,90,3,6,15,oglobo.globo.com___economia_ministro-diz-que-cronograma-da-reforma-trabalhista-esta-mantido-21363978.txt
1077,13,8,reforma-previdencia,oglobo,771,4,12,4,635,27,40,89,oglobo.globo.com___economia_na-camara-guedes-comemora-aprovacao-da-reforma-muito-satisfeito-23862469.txt
1078,6,6,reforma-trabalhista,oglobo,299,0,6,1,242,8,14,42,oglobo.globo.com___economia_oit-pede-informacoes-ao-brasil-sobre-reforma-trabalhista-21473082.txt
1079,7,4,reforma-trabalhista,oglobo,560,10,14,2,459,30,37,60,oglobo.globo.com___economia_oposicao-tenta-obstruir-reforma-trabalhista-na-ccj-21501951.txt
1080,1,4,reforma-trabalhista,oglobo,150,2,6,1,113,9,10,27,oglobo.globo.com___economia_pgr-pede-ao-supremo-suspensao-de-pontos-da-reforma-trabalhista-21756754.txt
1081,15,8,reforma-trabalhista,oglobo,524,8,16,3,417,28,43,63,oglobo.globo.com___economia_planalto-nao-cede-pressao-da-camara-sobre-reforma-trabalhista-21589740.txt
1082,3,-2,reforma-previdencia,oglobo,416,6,4,1,317,28,31,51,oglobo.globo.com___economia_plenario-do-senado-aprova-reforma-da-previdencia-cria-idade-minima-de-aposentadoria-1-24035375.txt
1083,11,0,reforma-trabalhista,oglobo,187,7,7,3,154,8,19,23,oglobo.globo.com___economia_presidente-do-tst-elogia-reforma-trabalhista-21587534.txt
1084,28,4,reforma-previdencia,oglobo,1381,12,16,4,1112,52,80,169,oglobo.globo.com___economia_previdencia-comissao-do-senado-derruba-todos-os-destaques-conclui-votacao-23927105.txt
1085,16,4,reforma-previdencia,oglobo,417,7,11,5,319,17,33,71,oglobo.globo.com___economia_previdencia-reforma-sera-aprovada-com-boa-margem-de-votos-diz-maia-23789233.txt
1086,3,6,reforma-previdencia,oglobo,307,0,6,1,251,10,13,40,oglobo.globo.com___economia_previdencia-relator-deixa-estados-municipios-fora-da-reforma-servidor-tera-nova-regra-de-transicao-23734154.txt
1087,5,3,reforma-previdencia,oglobo,201,0,3,0,166,4,9,25,oglobo.globo.com___economia_previdencia-relator-vai-incluir-regra-mais-branda-para-professoras-23777669.txt
1088,14,-5,reforma-previdencia,oglobo,643,14,9,5,526,35,49,61,oglobo.globo.com___economia_previdencia-senado-mantem-regra-do-abono-impoe-derrota-de-764-bi-ao-governo-23989038.txt
1089,-5,7,reforma-trabalhista,oglobo,466,9,16,2,381,33,28,51,oglobo.globo.com___economia_reacao-de-juizes-contrarios-reforma-trabalhista-gera-incertezas-21840705.txt
1090,0,1,afastamento-aecio,oglobo,131,1,2,1,107,7,7,14,oglobo.globo.com___economia_rede-de-pizzas-dominos-anuncia-boicote-produtos-da-jbs-21437061.txt
1091,8,-1,reforma-previdencia,oglobo,711,9,8,2,565,30,38,97,oglobo.globo.com___economia_reforma-da-previdencia-avanca-na-camara-mas-comissao-mantem-privilegios-de-pms-23785485.txt
1092,4,5,reforma-previdencia,oglobo,193,3,8,1,131,11,15,48,oglobo.globo.com___economia_reforma-da-previdencia-devera-mudar-regras-trabalhistas-para-jovens-23431614.txt
1093,4,10,reforma-previdencia,oglobo,1063,3,13,3,869,32,36,145,oglobo.globo.com___economia_reforma-da-previdencia-entenda-as-mudancas-ponto-ponto-23466073.txt
1094,-6,7,reforma-previdencia,oglobo,207,0,7,4,152,17,11,38,oglobo.globo.com___economia_reforma-da-previdencia-esta-pronta-sera-bem-diferente-de-minuta-vazada-diz-marinho-23447016.txt
1095,8,8,reforma-previdencia,oglobo,515,2,10,2,434,11,19,65,oglobo.globo.com___economia_reforma-da-previdencia-futuro-da-aposentadoria-23376613.txt
1096,1,2,reforma-previdencia,oglobo,412,4,6,4,325,17,18,66,oglobo.globo.com___economia_reforma-da-previdencia-sera-promulgada-nesta-terca-feira-20-dias-apos-sua-aprovacao-1-24075790.txt
1097,39,21,reforma-previdencia,oglobo,1533,7,28,5,1253,43,82,195,oglobo.globo.com___economia_reforma-da-previdencia-veja-as-regras-aprovadas-para-quem-esta-no-mercado-ou-ainda-vai-entrar-23805522.txt
1098,-6,-2,reforma-trabalhista,oglobo,295,9,7,0,245,21,15,30,oglobo.globo.com___economia_reforma-trabalhista-entra-em-vigor-neste-sabado-com-varios-pontos-que-ainda-vao-mudar-22053638.txt
1099,11,7,reforma-trabalhista,oglobo,491,5,12,3,408,21,32,50,oglobo.globo.com___economia_reforma-trabalhista-governo-vai-antecipar-pontos-nos-quais-fara-ajustes-na-reforma-trabalhista-21529710.txt
1100,10,4,reforma-trabalhista,oglobo,120,0,4,0,95,5,15,9,oglobo.globo.com___economia_reforma-trabalhista-permite-parcelar-ferias-em-ate-tres-vezes-veja-tira-duvidas-22039260.txt
1101,23,5,reforma-trabalhista,oglobo,559,9,14,2,439,27,50,68,oglobo.globo.com___economia_reforma-trabalhista-pode-adotar-contribuicao-negocial-21558962.txt
1102,17,10,reforma-trabalhista,oglobo,328,2,12,3,249,15,32,49,oglobo.globo.com___economia_reforma-trabalhista-pode-criar-demissao-de-comum-acordo-1-21209064.txt
1103,18,9,reforma-trabalhista,oglobo,330,6,15,4,258,21,39,37,oglobo.globo.com___economia_reforma-trabalhista-preve-mais-tres-tipos-de-contratos-21329475.txt
1104,-1,-1,reforma-trabalhista,oglobo,244,5,4,2,194,18,17,26,oglobo.globo.com___economia_reforma-trabalhista-que-governo-ainda-promete-mudar-21580517.txt
1105,3,2,reforma-trabalhista,oglobo,174,3,5,1,133,9,12,29,oglobo.globo.com___economia_reforma-trabalhista-relator-considera-retirada-de-artigo-que-permite-gestante-em-locais-insalubres-21253633.txt
1106,10,8,reforma-trabalhista,oglobo,484,5,13,3,396,21,31,57,oglobo.globo.com___economia_reforma-trabalhista-relator-deixara-sugestoes-de-mudancas-explicitas-em-relatorio-21348692.txt
1107,18,2,reforma-trabalhista,oglobo,413,5,7,4,318,13,31,67,oglobo.globo.com___economia_reforma-trabalhista-senado-faz-terceira-audiencia-em-dois-dias-21325158.txt
1108,29,8,reforma-trabalhista,oglobo,355,7,15,3,286,16,45,33,oglobo.globo.com___economia_reforma-trabalhista-so-comeco-21278054.txt
1109,17,4,reforma-trabalhista,oglobo,207,3,7,0,166,3,20,28,oglobo.globo.com___economia_reforma-trabalhista-trabalho-interminente-gera-duvidas-22078100.txt
1110,-5,-9,reforma-trabalhista,oglobo,124,10,1,1,107,10,5,14,oglobo.globo.com___economia_rejeicao-de-texto-da-reforma-trabalhista-demonstra-que-pais-continua-dividido-diz-renan-21498373.txt
1111,-13,7,reforma-previdencia,oglobo,652,17,24,5,519,55,42,82,oglobo.globo.com___economia_relatorio-da-reforma-da-previdencia-aprovado-na-ccj-com-48-votos-favor-18-contra-23617667.txt
1112,12,1,reforma-trabalhista,oglobo,214,2,3,1,169,7,19,25,oglobo.globo.com___economia_relatorio-da-reforma-trabalhista-preve-mudancas-em-seis-itens-21383877.txt
1113,12,6,reforma-trabalhista,oglobo,277,3,9,1,210,16,28,36,oglobo.globo.com___economia_relatorio-da-reforma-trabalhista-revoga-18-itens-da-clt-altera-90-21194463.txt
1114,11,3,reforma-previdencia,oglobo,381,3,6,5,282,16,27,70,oglobo.globo.com___economia_responsabilidade-daqui-para-frente-do-governo-diz-maia-sobre-reforma-da-previdencia-23543257.txt
1115,2,0,reforma-trabalhista,oglobo,83,0,0,0,63,4,6,10,oglobo.globo.com___economia_ricardo-ferraco-sera-relator-da-reforma-trabalhista-em-comissao-no-senado-21288037.txt
1116,3,10,reforma-trabalhista,oglobo,185,2,12,0,154,8,11,26,oglobo.globo.com___economia_romero-juca-assume-relatoria-da-reforma-trabalhista-na-ccj-21295942.txt
1117,17,9,reforma-trabalhista,oglobo,538,6,15,5,436,24,41,63,oglobo.globo.com___economia_saiba-como-fica-agora-reforma-trabalhista-21498919.txt
1118,-1,8,reforma-previdencia,oglobo,426,2,10,2,339,22,21,58,oglobo.globo.com___economia_senado-aprova-pec-paralela-mas-cria-regra-de-transicao-para-calculo-da-aposentadoria-24089133.txt
1119,13,1,reforma-trabalhista,oglobo,853,13,14,2,679,41,54,108,oglobo.globo.com___economia_senadores-fazem-acordo-adiam-votacao-da-reforma-trabalhista-para-proxima-terca-21411946.txt
1120,11,-2,reforma-trabalhista,oglobo,176,4,2,1,138,4,15,26,oglobo.globo.com___economia_sindicalistas-apelam-temer-para-mudancas-na-reforma-trabalhista-21472456.txt
1121,-1,3,reforma-trabalhista,oglobo,109,1,4,1,91,5,4,15,oglobo.globo.com___economia_stf-nega-pedido-para-suspender-votacao-de-reforma-trabalhista-21262387.txt
1122,10,2,reforma-trabalhista,oglobo,262,1,3,1,213,8,18,28,oglobo.globo.com___economia_veja-os-pontos-da-reforma-trabalhista-que-governo-deve-alterar-21587974.txt
1123,13,-1,reforma-trabalhista,oglobo,207,9,8,4,161,11,24,32,oglobo.globo.com___opiniao_aprovar-reforma-trabalhista-essencial-21435146.txt
1124,-14,-14,afastamento-aecio,oglobo,191,17,3,3,151,27,13,23,oglobo.globo.com___opiniao_cupula-do-psdb-opta-pela-velha-politica-21474713.txt
1125,-7,-12,prisao-lula,oglobo,525,26,14,4,429,34,27,79,oglobo.globo.com___opiniao_prisao-de-lula-reforca-estado-de-direito-22562673.txt
1126,-2,-4,reforma-trabalhista,oglobo,260,9,5,4,211,18,16,33,oglobo.globo.com___opiniao_reforma-trabalhista-incentiva-emprego-formal-21589032.txt
1127,12,8,reforma-trabalhista,estadao,280,6,14,2,242,12,24,24,"opiniao.estadao.com.br___noticias_geral,a-reforma-trabalhista,70002034201.txt"
1128,20,-5,reforma-trabalhista,estadao,298,9,4,4,213,17,37,48,"opiniao.estadao.com.br___noticias_geral,sindicalismo-preguicoso,70002074379.txt"
1129,29,9,reforma-trabalhista,estadao,646,13,22,5,502,28,57,99,politica.estadao.com.br___blogs_blog-do-fucs_carlos-langoni_.txt
1130,-2,-8,afastamento-aecio,estadao,330,9,1,3,277,21,19,26,politica.estadao.com.br___blogs_coluna-do-estadao_aecio-recebe-aplausos-em-reuniao-dos-tucanos_.txt
1131,2,-4,soltura-lula,estadao,302,10,6,1,239,19,21,40,politica.estadao.com.br___blogs_coluna-do-estadao_alto-comando-militar-frustrado-com-ministra-rosa-weber_.txt
1132,12,7,impeachment-dilma,estadao,544,26,33,6,436,32,44,97,politica.estadao.com.br___blogs_coluna-do-estadao_apos-aprovacao-do-impeachment-dilma-se-pronuncia-e-diz-que-ira-recorrer_.txt
1133,7,-8,prisao-lula,estadao,275,14,6,0,245,12,19,19,politica.estadao.com.br___blogs_coluna-do-estadao_gilmar-mendes-nega-pedido-de-lula-para-ser-solto-e-forma-maioria_.txt
1134,3,0,reforma-trabalhista,estadao,71,2,2,1,58,4,7,7,politica.estadao.com.br___blogs_coluna-do-estadao_governo-vai-apoiar-fim-do-imposto-sindical_.txt
1135,-2,0,reforma-trabalhista,estadao,55,2,2,1,47,4,2,7,politica.estadao.com.br___blogs_coluna-do-estadao_meirelles-questiona-maia-sobre-possibilidade-de-aprovar-reforma-da-previdencia_.txt
1136,-1,-2,reforma-trabalhista,estadao,85,2,0,0,72,3,2,10,politica.estadao.com.br___blogs_coluna-do-estadao_por-reforma-governo-suspendeu-audiencias_.txt
1137,2,0,afastamento-aecio,estadao,65,2,2,0,54,3,5,7,politica.estadao.com.br___blogs_coluna-do-estadao_stf-determinou-afastamento-de-aecio-neves-e-rocha-loures-dos-mandatos_.txt
1138,12,-3,prisao-lula,estadao,313,8,5,4,257,11,23,39,politica.estadao.com.br___blogs_coluna-do-estadao_supremo-pode-conceder-prisao-domiciliar-para-lula_.txt
1139,-6,-8,impeachment-dilma,estadao,264,16,8,3,214,17,11,49,politica.estadao.com.br___blogs_fausto-macedo_a-historia-me-reservou-este-momento-diz-collor-pelo-impeachment-de-dilma_.txt
1140,16,-3,prisao-lula,estadao,341,18,15,6,251,24,40,65,politica.estadao.com.br___blogs_fausto-macedo_a-prisao-de-lula-vai-mudar-o-brasil_.txt
1141,-12,-7,prisao-lula,estadao,387,13,6,1,341,21,9,36,politica.estadao.com.br___blogs_fausto-macedo_abaixo-assinado-por-prisao-em-2-o-grau-busca-sensibilizar-ministros-a-48-horas-do-dia-d-de-lula_.txt
1142,-12,-7,prisao-lula,estadao,140,9,2,0,125,14,2,10,politica.estadao.com.br___blogs_fausto-macedo_acusados-de-tentativa-de-homicidio-em-frente-ao-instituto-lula-se-entregam-a-policia_.txt
1143,1,-2,afastamento-aecio,estadao,126,3,1,0,100,6,7,17,politica.estadao.com.br___blogs_fausto-macedo_advogado-do-escritorio-que-defende-aecio-na-lava-jato-foi-raptado-com-um-dia-de-vida_.txt
1144,8,1,impeachment-dilma,estadao,208,0,1,0,169,5,13,22,politica.estadao.com.br___blogs_fausto-macedo_ao-vivo-camara-decide-se-abre-processo-de-impeachment-de-dilma_.txt
1145,-4,8,prisao-lula,estadao,306,9,17,0,264,25,21,22,politica.estadao.com.br___blogs_fausto-macedo_defesa-de-lula-entrou-com-78-recursos-no-caso-triplex_.txt
1146,-4,-1,prisao-lula,estadao,300,12,11,0,247,23,19,34,politica.estadao.com.br___blogs_fausto-macedo_defesa-diz-a-fachin-que-lula-foi-preso-antes-do-fim-de-recursos-a-segunda-instancia_.txt
1147,-4,-2,prisao-lula,estadao,50,3,1,2,46,5,1,4,politica.estadao.com.br___blogs_fausto-macedo_duas-sentencas-depois-lula-ainda-e-reu-em-cinco-acoes-e-alvo-de-tres-denuncias_.txt
1148,10,2,afastamento-aecio,estadao,373,11,13,3,315,17,27,41,politica.estadao.com.br___blogs_fausto-macedo_em-audios-aecio-ja-defendia-troca-de-serraglio-por-ministro-forte-para-mexer-com-pf_.txt
1149,0,-2,prisao-lula,estadao,108,3,1,0,95,8,8,1,politica.estadao.com.br___blogs_fausto-macedo_humberto-martins-nega-pedido-para-lula-dar-entrevista-da-cadeia-da-lava-jato_.txt
1150,-11,-4,afastamento-aecio,estadao,296,8,4,0,251,27,16,14,politica.estadao.com.br___blogs_fausto-macedo_janot-denuncia-aecio_.txt
1151,23,-12,afastamento-aecio,estadao,566,26,14,2,464,29,52,63,politica.estadao.com.br___blogs_fausto-macedo_janot-quer-delegado-da-pf-exclusivo-e-de-sua-confianca-no-inquerito-temer_.txt
1152,0,0,impeachment-dilma,estadao,48,0,0,0,38,2,2,6,politica.estadao.com.br___blogs_fausto-macedo_leia-a-integra-da-carta-de-dilma-a-comissao-do-impeachment_.txt
1153,3,-1,prisao-lula,estadao,202,3,2,1,178,7,10,13,politica.estadao.com.br___blogs_fausto-macedo_lula-deixa-sindicato-para-a-prisao-da-lava-jato_.txt
1154,-5,-5,soltura-lula,estadao,155,10,5,0,141,11,6,12,politica.estadao.com.br___blogs_fausto-macedo_lula-livre-volta-ao-palanque-e-ataca-lado-podre-mentiroso-e-canalha-da-justica-do-ministerio-publico-da-receita-e-da-policia-federal_.txt
1155,-9,-17,prisao-lula,estadao,280,21,4,2,252,24,15,16,politica.estadao.com.br___blogs_fausto-macedo_lula-pode-pegar-ate-118-anos-de-prisao_.txt
1156,-2,-1,soltura-lula,estadao,540,16,15,3,431,45,43,55,politica.estadao.com.br___blogs_fausto-macedo_lula-pode-ser-candidato-vejas-os-cenarios-possiveis-para-que-o-ex-presidente-volte-a-ficar-elegivel_.txt
1157,2,-7,soltura-lula,estadao,411,20,13,6,340,27,29,54,politica.estadao.com.br___blogs_fausto-macedo_lula-solto-nao-livre-radicalizacao-preocupante_.txt
1158,-2,-3,prisao-lula,estadao,92,3,0,0,83,5,3,4,politica.estadao.com.br___blogs_fausto-macedo_na-prisao-de-lula-tem-carne-assada-chuchu-e-macarrao-no-jantar_.txt
1159,60,15,reforma-trabalhista,estadao,984,6,21,2,775,35,95,108,politica.estadao.com.br___blogs_fausto-macedo_nova-lei-trabalhista-dia-11-saiba-quais-sao-as-principais-mudancas_.txt
1160,26,1,soltura-lula,estadao,413,12,13,2,341,18,44,37,politica.estadao.com.br___blogs_fausto-macedo_o-pedido-de-soltura-de-lula_.txt
1161,83,56,impeachment-dilma,estadao,5813,143,199,41,4815,301,384,696,politica.estadao.com.br___blogs_fausto-macedo_o-que-estao-dizendo-os-senadores-sobre-impeachment-de-dilma_.txt
1162,-10,-2,afastamento-aecio,estadao,121,3,1,1,98,15,5,8,politica.estadao.com.br___blogs_fausto-macedo_o-relatorio-da-apreensao-de-arma-em-fazenda-de-aecio_.txt
1163,16,-7,afastamento-aecio,estadao,934,22,15,3,769,49,65,91,politica.estadao.com.br___blogs_fausto-macedo_os-caminhos-da-propina-a-aecio-segundo-delator_.txt
1164,9,8,impeachment-dilma,estadao,268,9,17,3,248,9,18,22,politica.estadao.com.br___blogs_fausto-macedo_para-especialistas-stf-nao-vai-interferir-no-processo-de-impeachment_.txt
1165,7,-7,prisao-lula,estadao,353,18,11,1,291,23,30,39,politica.estadao.com.br___blogs_fausto-macedo_preso-ha-100-dias-lula-mantem-pt-imobilizado_.txt
1166,12,8,prisao-lula,estadao,217,4,12,2,186,11,23,15,politica.estadao.com.br___blogs_fausto-macedo_preso-lula-diz-em-carta-que-pt-pode-ficar-a-vontade-sobre-candidatura_.txt
1167,-3,-12,prisao-lula,estadao,417,16,4,1,362,24,21,31,politica.estadao.com.br___blogs_fausto-macedo_preso-na-lava-jato-lula-ainda-enfrenta-mais-sete-processos_.txt
1168,-6,2,prisao-lula,estadao,251,11,13,4,233,15,9,22,politica.estadao.com.br___blogs_fausto-macedo_toda-essa-palhacada-com-o-meu-nome-nao-pode-ter-um-fim-se-eu-nao-for-preso_.txt
1169,63,19,reforma-trabalhista,estadao,1048,25,44,2,812,58,121,128,politica.estadao.com.br___blogs_fausto-macedo_trabalhadores-nao-perdem-direitos-com-a-nova-lei-afirmam-especialistas_.txt
1170,-3,0,prisao-lula,estadao,299,11,11,2,252,26,23,22,politica.estadao.com.br___blogs_fausto-macedo_tribunal-publica-acordao-do-julgamento-que-afundou-lula_.txt
1171,25,2,prisao-lula,estadao,742,22,24,6,590,41,66,97,politica.estadao.com.br___blogs_fausto-macedo_visitas-de-amigos-a-lula-estao-proibidas-durante-encarceramento-na-pf-decide-justica_.txt
1172,1,-5,soltura-lula,estadao,142,7,2,0,132,6,7,6,politica.estadao.com.br___blogs_fausto-macedo_ze-dirceu-solto_.txt
1173,11,-7,prisao-lula,estadao,215,15,8,4,187,10,21,24,politica.estadao.com.br___blogs_neumanne_as-portas-da-cadeia_.txt
1174,-9,-6,prisao-lula,estadao,202,10,4,0,164,20,11,21,"politica.estadao.com.br___noticias_eleicoes,ciro-diz-que-lula-so-tem-chance-de-sair-da-cadeia-se-ele-assumir-o-poder,70002413822.txt"
1175,1,-10,prisao-lula,estadao,243,10,0,1,209,10,11,24,"politica.estadao.com.br___noticias_eleicoes,da-prisao-lula-declara-apoio-a-marilia-arraes-ao-governo-de-pernambuco-nas-eleicoes-2018,70002389678.txt"
1176,-4,-18,prisao-lula,estadao,203,20,2,1,183,12,8,23,"politica.estadao.com.br___noticias_geral,a-al-jazeera-gleisi-diz-que-lula-e-preso-politico-e-pede-campanha-por-sua-libertacao,70002273533.txt"
1177,3,4,afastamento-aecio,estadao,367,1,5,2,281,20,23,51,"politica.estadao.com.br___noticias_geral,aecio-usa-foto-com-motoqueiros-para-se-defender-de-grampo-de-conversa-cifrada,70001820795.txt"
1178,12,2,impeachment-dilma,estadao,215,2,4,6,162,8,20,37,"politica.estadao.com.br___noticias_geral,aliados-de-cunha-querem-adiamento-de-votacao,10000073615.txt"
1179,-4,-5,prisao-lula,estadao,262,8,3,2,211,18,14,32,"politica.estadao.com.br___noticias_geral,ao-pt-defesa-de-lula-descarta-prisao-domiciliar,70002368652.txt"
1180,-1,-2,soltura-lula,estadao,162,7,5,1,138,10,9,18,"politica.estadao.com.br___noticias_geral,apoiadores-de-lula-fazem-festa-e-oferecem-cachaca-em-frente-ao-supremo,70003080755.txt"
1181,-5,-3,impeachment-dilma,estadao,259,7,4,2,207,22,17,26,"politica.estadao.com.br___noticias_geral,apos-reuniao-de-liderancas--psdb-reitera-apoio-a-impeachment-de-dilma,10000025607.txt"
1182,0,-4,soltura-lula,estadao,96,5,1,0,78,3,3,18,"politica.estadao.com.br___noticias_geral,apos-soltura-de-lula-fhc-afirma-que-polarizacao-aumenta,70003084002.txt"
1183,10,-3,soltura-lula,estadao,280,7,4,2,238,9,19,27,"politica.estadao.com.br___noticias_geral,apos-soltura-de-lula-polarizacao-politica-preocupa-mercado,70003082260.txt"
1184,-8,-4,prisao-lula,estadao,543,17,13,1,431,38,30,75,"politica.estadao.com.br___noticias_geral,assassinato-de-marielle-e-prisao-de-lula-fazem-parte-do-mesmo-processo-diz-pt,70002229190.txt"
1185,-3,2,soltura-lula,estadao,318,8,10,1,249,20,17,51,"politica.estadao.com.br___noticias_geral,bastidores-estrategia-do-planalto-e-deixar-lula-falando-sozinho,70003093682.txt"
1186,11,1,reforma-previdencia,estadao,362,8,9,4,280,17,28,58,"politica.estadao.com.br___noticias_geral,bolsonaro-e-maia-acertam-acao-pela-previdencia-e-nao-descartam-nomeacoes-politicas,70002749383.txt"
1187,-13,-8,prisao-lula,estadao,299,11,3,2,251,24,11,29,"politica.estadao.com.br___noticias_geral,caravana-de-lula-e-atacada-em-santa-catarina,70002241988.txt"
1188,-11,-13,prisao-lula,estadao,205,17,4,3,176,20,9,24,"politica.estadao.com.br___noticias_geral,ciro-gomes-diz-que-lula-nao-e-preso-politico,70002261717.txt"
1189,1,2,impeachment-dilma,estadao,97,0,2,0,77,6,7,9,"politica.estadao.com.br___noticias_geral,comissao-do-impeachment-comeca-a-ouvir-testemunhas-da-defesa-de-dilma,10000057092.txt"
1190,3,2,impeachment-dilma,estadao,88,0,2,0,75,1,4,10,"politica.estadao.com.br___noticias_geral,comissao-do-impeachment-ouve-primeiras-testemunhas-da-acusacao-nesta-quarta,10000055909.txt"
1191,0,-4,impeachment-dilma,estadao,368,6,2,2,298,19,19,42,"politica.estadao.com.br___noticias_geral,contra-impeachment--dilma-negocia-cargos-com-poder-sobre-r-38-bilhoes,10000025744.txt"
1192,-7,-8,soltura-lula,estadao,287,15,7,4,239,27,20,27,"politica.estadao.com.br___noticias_geral,debate-a-proposta-de-soltar-lula-deveria-ter-sido-aceita-pelo-supremo,70002888294.txt"
1193,-2,-7,soltura-lula,estadao,289,18,11,4,243,22,20,37,"politica.estadao.com.br___noticias_geral,decisao-abre-caminho-para-soltar-lula,70003080656.txt"
1194,-2,2,impeachment-dilma,estadao,191,2,4,1,146,16,14,22,"politica.estadao.com.br___noticias_geral,decisao-de-prosseguimento-do-impeachment-tera-5-votacoes-na-madrugada-desta-quarta,10000068281.txt"
1195,-1,-9,afastamento-aecio,estadao,354,11,2,3,308,18,17,27,"politica.estadao.com.br___noticias_geral,delacao-cita-publicidade-como-propina-a-aecio,70001803754.txt"
1196,24,-3,impeachment-dilma,estadao,210,8,5,0,168,6,30,19,"politica.estadao.com.br___noticias_geral,deputado-vai-ao-stf-para-juntar-pedido-de-impeachment-de-temer-a-processo-contra-dilma,10000025140.txt"
1197,-9,-3,prisao-lula,estadao,127,3,0,1,103,12,3,13,"politica.estadao.com.br___noticias_geral,deputados-petistas-entram-na-camara-com-cartazes-de-lula-livre,70002263089.txt"
1198,-16,-1,soltura-lula,estadao,242,9,8,0,214,24,8,13,"politica.estadao.com.br___noticias_geral,dez-meses-da-prisao-de-lula-relembre-as-tentativas-de-soltar-o-ex-presidente,70002711948.txt"
1199,4,4,impeachment-dilma,estadao,129,1,5,0,103,5,9,18,"politica.estadao.com.br___noticias_geral,dilma-recebeu-collor-por-mais-de-duas-horas-no-alvorada-na-sexta-feira,10000072413.txt"
1200,1,4,impeachment-dilma,estadao,148,2,6,0,122,6,7,21,"politica.estadao.com.br___noticias_geral,dilma-reune-senadores-contrarios-ao-impeachment-para-avaliar-chances-de-reverter-afastamento,10000052058.txt"
1201,-4,5,soltura-lula,estadao,194,4,9,2,163,14,10,22,"politica.estadao.com.br___noticias_geral,em-passagem-por-goiania-bolsonaro-ignora-soltura-de-lula,70003082010.txt"
1202,11,0,prisao-lula,estadao,274,8,8,4,223,17,28,26,"politica.estadao.com.br___noticias_geral,estou-com-a-tranquilidade-dos-inocentes-diz-lula,70002238114.txt"
1203,5,8,prisao-lula,estadao,240,10,18,0,208,15,20,25,"politica.estadao.com.br___noticias_geral,ex-governador-de-sao-paulo-classifica-prisao-de-lula-como-equivocada,70002376467.txt"
1204,4,-5,prisao-lula,estadao,199,11,6,2,169,8,12,29,"politica.estadao.com.br___noticias_geral,fhc-afirma-que-justica-se-cumpriu-com-prisao-de-lula,70002264599.txt"
1205,7,1,impeachment-dilma,estadao,835,25,26,5,696,43,50,102,"politica.estadao.com.br___noticias_geral,g-8-do-impeachment-teve-reunioes-durante-um-ano,10000026435.txt"
1206,8,5,afastamento-aecio,estadao,153,1,6,1,130,5,13,13,"politica.estadao.com.br___noticias_geral,gabinete-de-aecio-pode-funcionar-com-normalidade-diz-stf,70001841378.txt"
1207,-3,5,impeachment-dilma,estadao,97,0,5,0,74,6,3,19,"politica.estadao.com.br___noticias_geral,governistas-querem-barrar-testemunhas-da-defesa-de-dilma-na-comissao-do-impeachment,10000054865.txt"
1208,1,3,impeachment-dilma,estadao,194,2,5,3,158,10,11,25,"politica.estadao.com.br___noticias_geral,governo-e-oposicao-pressionam-ministros-por-decisao-de-impeachment,10000021245.txt"
1209,-1,-5,soltura-lula,estadao,625,9,4,7,504,26,25,90,"politica.estadao.com.br___noticias_geral,governo-reage-a-lula-e-a-rodrigo-maia-e-busca-pacote-social,70003101508.txt"
1210,3,-4,prisao-lula,estadao,191,7,3,1,168,4,7,23,"politica.estadao.com.br___noticias_geral,imprensa-internacional-diz-que-stf-abre-porta-a-prisao-de-lula,70002255109.txt"
1211,4,-3,impeachment-dilma,estadao,81,5,2,1,67,6,10,6,"politica.estadao.com.br___noticias_geral,janaina-paschoal-chora-e-pede-desculpas-a-dilma-por-ter-causado-sofrimento,10000072903.txt"
1212,-13,7,impeachment-dilma,estadao,256,1,8,0,217,20,7,21,"politica.estadao.com.br___noticias_geral,janot-e-contra-pedido-para-anular-impeachment-por-atuacao-de-cunha,10000074371.txt"
1213,2,0,afastamento-aecio,estadao,138,1,1,1,119,5,7,10,"politica.estadao.com.br___noticias_geral,janot-pede-mais-60-dias-para-conclusao-de-investigacoes-contra-aecio,70001859237.txt"
1214,-17,-15,impeachment-dilma,estadao,220,18,3,5,183,30,13,20,"politica.estadao.com.br___noticias_geral,jean-wyllys-cospe-em-direcao-a-bolsonaro-apos-votar-contra-impeachment,10000026656.txt"
1215,-3,-6,prisao-lula,estadao,159,10,4,0,140,13,10,10,"politica.estadao.com.br___noticias_geral,jornalistas-sao-agredidos-por-manifestantes-pro-lula-em-sao-bernardo-e-brasilia,70002257033.txt"
1216,-5,-5,impeachment-dilma,estadao,449,17,12,5,370,30,25,58,"politica.estadao.com.br___noticias_geral,juristas-que-pedem-impeachment-falam-a-comissao-da-camara,10000023930.txt"
1217,-2,-4,reforma-trabalhista,estadao,310,4,0,2,246,14,12,44,"politica.estadao.com.br___noticias_geral,lider-do-governo-juca-assina-documento-de-apoio-a-renan,70001762444.txt"
1218,7,0,soltura-lula,estadao,531,18,18,6,420,37,44,72,"politica.estadao.com.br___noticias_geral,lideres-projetam-cenario-com-lula-em-liberdade,70003064317.txt"
1219,3,-2,prisao-lula,estadao,109,6,4,1,90,5,8,17,"politica.estadao.com.br___noticias_geral,luciano-huck-diz-que-prisao-de-lula-e-uma-pena-uma-tristeza,70002259186.txt"
1220,2,-6,prisao-lula,estadao,332,16,10,2,296,14,16,34,"politica.estadao.com.br___noticias_geral,lula-diz-que-nao-tem-medo-de-ser-preso-e-reage-a-odio-de-manifestantes,70002236499.txt"
1221,0,1,prisao-lula,estadao,123,5,6,0,109,6,6,13,"politica.estadao.com.br___noticias_geral,lula-esta-emocionado-com-cartas-e-apoio-diz-instituto,70002266194.txt"
1222,-7,-1,soltura-lula,estadao,221,9,8,1,184,16,9,30,"politica.estadao.com.br___noticias_geral,lula-esta-solto-mas-continua-com-todos-os-crimes-dele-nas-costas-diz-bolsonaro,70003082787.txt"
1223,1,-5,soltura-lula,estadao,184,8,3,1,145,11,12,28,"politica.estadao.com.br___noticias_geral,lula-estava-cetico-em-relacao-a-uma-eventual-soltura-diz-gleisi,70002653442.txt"
1224,0,-5,prisao-lula,estadao,142,6,1,0,133,6,6,4,"politica.estadao.com.br___noticias_geral,lula-nao-se-entrega-e-militantes-do-pt-encerram-ato-em-curitiba,70002258026.txt"
1225,7,-21,soltura-lula,estadao,1148,39,18,3,958,53,60,137,"politica.estadao.com.br___noticias_geral,manifestantes-cobram-pec-da-segunda-instancia-na-avenida-paulista,70003082741.txt"
1226,-4,0,prisao-lula,estadao,165,8,8,0,150,10,6,15,"politica.estadao.com.br___noticias_geral,manifestantes-jogam-tinta-vermelha-no-stf-e-pedem-liberdade-de-lula,70002413346.txt"
1227,6,0,prisao-lula,estadao,133,3,3,0,115,2,8,14,"politica.estadao.com.br___noticias_geral,manuela-davila-diz-que-prisao-de-lula-sera-denunciada-como-perseguicao-politica-na-america-latina,70002260181.txt"
1228,10,-10,reforma-trabalhista,estadao,399,11,1,1,314,19,29,50,"politica.estadao.com.br___noticias_geral,manuela-davila-diz-que-se-chegar-a-presidencia-vai-propor-revogacao-da-reforma-trabalhista,70002088558.txt"
1229,8,-5,impeachment-dilma,estadao,289,11,6,0,243,16,24,23,"politica.estadao.com.br___noticias_geral,marina-silva-defende-que-parlamentares-do-rede-votem-pelo-impeachment-de-dilma,10000025763.txt"
1230,19,21,reforma-trabalhista,estadao,1414,37,58,12,1124,93,112,192,"politica.estadao.com.br___noticias_geral,meu-principal-objetivo-e-combater-o-desemprego,70001779781.txt"
1231,-1,-2,soltura-lula,estadao,100,3,1,0,84,6,5,9,"politica.estadao.com.br___noticias_geral,mourao-sobre-decisao-do-stf-onde-esta-o-estado-de-direito-no-brasil,70003081338.txt"
1232,2,1,impeachment-dilma,estadao,175,1,2,1,142,3,5,29,"politica.estadao.com.br___noticias_geral,no-dia-da-votacao-do-impeachment--dilma-mantem-rotina-matinal-de-exercicio,10000026528.txt"
1233,-4,1,soltura-lula,estadao,123,3,4,0,97,11,7,15,"politica.estadao.com.br___noticias_geral,no-twitter-bolsonaro-atribui-a-soltura-de-lula-oscilacoes-na-bolsa,70003084100.txt"
1234,6,-11,soltura-lula,estadao,414,17,6,1,331,25,31,51,"politica.estadao.com.br___noticias_geral,o-julgamento-do-stf-sobre-segunda-instancia-pode-soltar-lula,70003052346.txt"
1235,4,-1,impeachment-dilma,estadao,349,5,4,4,281,17,21,43,"politica.estadao.com.br___noticias_geral,oab-decide--por-27-votos-a-2--apoiar-o-pedido-de-impeachment-de-dilma-no-congresso,10000022109.txt"
1236,0,-5,impeachment-dilma,estadao,456,9,4,0,371,28,28,42,"politica.estadao.com.br___noticias_geral,pais-tem-protestos-contra-impeachment-e-comemoracao-de-grupos-anti-dilma,10000073314.txt"
1237,3,2,impeachment-dilma,estadao,50,0,2,0,44,0,3,5,"politica.estadao.com.br___noticias_geral,papelada-do-impeachment-chega-ao-senado,10000026815.txt"
1238,10,2,afastamento-aecio,estadao,254,10,12,5,217,16,26,22,"politica.estadao.com.br___noticias_geral,para-advogado-de-aecio-recolhimento-noturno-e-medida-do-ai-5,70002024972.txt"
1239,-4,-10,impeachment-dilma,estadao,504,14,4,5,414,27,23,63,"politica.estadao.com.br___noticias_geral,para-defender-dilma--ex-presidente-da-oab-compara-impeachment-com-caso-collor,10000048831.txt"
1240,-1,-11,impeachment-dilma,estadao,129,11,0,1,99,12,11,19,"politica.estadao.com.br___noticias_geral,pdt-expulsara-seis-deputados-que-votaram-a-favor-do-impeachment,10000026829.txt"
1241,-1,-1,impeachment-dilma,estadao,103,1,0,0,85,5,4,10,"politica.estadao.com.br___noticias_geral,placar-do-impeachment-mostra-277-votos-a-favor-e-114-contra-o-afastamento-de-dilma,10000025554.txt"
1242,-4,-7,soltura-lula,estadao,239,13,6,3,184,22,18,37,"politica.estadao.com.br___noticias_geral,pobre-deste-povo-famila-bolsonaro-lamenta-decisao-do-stf-que-pode-beneficiar-lula,70003081195.txt"
1243,3,-5,impeachment-dilma,estadao,290,8,3,5,240,10,13,43,"politica.estadao.com.br___noticias_geral,politicos-marcam-presenca-em-manifestacoes-pelo-brasil,10000020996.txt"
1244,-9,3,afastamento-aecio,estadao,479,6,9,3,422,24,15,36,"politica.estadao.com.br___noticias_geral,por-44-votos-a-26-senado-devolve-mandato-ao-senador-aecio-neves,70002050138.txt"
1245,2,-6,impeachment-dilma,estadao,318,15,9,2,259,21,23,41,"politica.estadao.com.br___noticias_geral,por-450-votos-a-10-camara-cassa-mandato-de-eduardo-cunha-algoz-de-dilma-no-impeachment,10000075657.txt"
1246,3,-17,prisao-lula,estadao,274,19,2,1,249,14,17,16,"politica.estadao.com.br___noticias_geral,pre-candidato-a-presidencia-e-lider-do-mtst-guilherme-boulos-ocupa-o-triplex-do-guaruja,70002270206.txt"
1247,-4,2,impeachment-dilma,estadao,111,4,6,0,85,10,6,20,"politica.estadao.com.br___noticias_geral,presidente-da-bolivia-diz-que-vai-retirar-embaixador-no-brasil-se-impeachment-for-aprovado,10000073111.txt"
1248,2,2,impeachment-dilma,estadao,270,4,6,4,221,12,14,37,"politica.estadao.com.br___noticias_geral,presidente-da-camara-marca-votacao-de-cassacao-de-cunha-para-12-de-setembro-apos-impeachment,10000068498.txt"
1249,-2,-9,prisao-lula,estadao,139,13,4,0,129,9,7,11,"politica.estadao.com.br___noticias_geral,prisao-de-lula-e-ilegal-acima-da-constituicao-e-politica-diz-renan-calheiros,70002257754.txt"
1250,-26,-73,prisao-lula,estadao,2228,123,50,9,1955,156,130,169,"politica.estadao.com.br___noticias_geral,prisao-de-lula-tudo-o-que-voce-precisa-saber,70002257053.txt"
1251,19,-12,prisao-lula,estadao,405,26,14,3,332,22,41,53,"politica.estadao.com.br___noticias_geral,prisao-de-lula-une-pt-e-planalto-contra-2-instancia,70002266401.txt"
1252,0,-2,prisao-lula,estadao,257,10,8,3,218,18,18,24,"politica.estadao.com.br___noticias_geral,pt-aposta-em-mobilizacoes-e-stf-para-reverter-prisao-de-lula,70002259772.txt"
1253,3,4,impeachment-dilma,estadao,192,1,5,0,151,7,10,30,"politica.estadao.com.br___noticias_geral,pt-quer-trazer-gravacao-de-juca-para-segunda-fase-do-processo-de-impeachment,10000053412.txt"
1254,-2,-5,prisao-lula,estadao,370,12,7,3,326,18,16,32,"politica.estadao.com.br___noticias_geral,quem-e-o-desembargador-plantonista-que-mandou-soltar-lula,70002395319.txt"
1255,0,-6,soltura-lula,estadao,382,18,12,5,308,31,31,47,"politica.estadao.com.br___noticias_geral,rosa-weber-deve-indicar-rumo-de-julgamento-da-2-instancia-no-stf,70003061499.txt"
1256,-13,-15,prisao-lula,estadao,463,25,10,2,354,33,20,93,"politica.estadao.com.br___noticias_geral,sem-lula-esquerda-nao-tem-candidato-diz-historiador,70002259279.txt"
1257,-4,-4,impeachment-dilma,estadao,197,8,4,5,153,17,13,31,"politica.estadao.com.br___noticias_geral,senadores-falam-sobre-pedido-de-prisao-de-renan-pela-primeira-vez-na-comissao-do-impeachment,10000057008.txt"
1258,2,2,impeachment-dilma,estadao,152,1,3,0,125,6,8,17,"politica.estadao.com.br___noticias_geral,stf-define-que-rito-do-impeachment-no-senado-deve-ser-o-mesmo-usado-para-collor,10000027300.txt"
1259,1,2,impeachment-dilma,estadao,165,3,5,0,132,11,12,18,"politica.estadao.com.br___noticias_geral,supremo-termina-de-publicar-acordao-sobre-rito-do-impeachment,10000020113.txt"
1260,5,-3,impeachment-dilma,estadao,206,6,3,1,172,11,16,17,"politica.estadao.com.br___noticias_geral,temer-ja-se-comporta-como-efetivo,10000071872.txt"
1261,0,-5,prisao-lula,estadao,180,7,2,1,161,5,5,19,"politica.estadao.com.br___noticias_geral,the-new-york-times-destaca-prisao-de-lula-na-capa-e-cita-virada-nas-eleicoes,70002259684.txt"
1262,1,7,impeachment-dilma,estadao,228,2,9,1,192,11,12,25,"politica.estadao.com.br___noticias_geral,tucano-e-eleito-relator-do-impeachment-no-senado,10000028121.txt"
1263,-2,-1,afastamento-aecio,estadao,225,5,4,0,192,9,7,26,"politica.estadao.com.br___noticias_geral,tucanos-defendem-fora-temer-e-afastamento-de-aecio-em-congresso-da-une,70001849530.txt"
1264,-2,-5,prisao-lula,estadao,155,10,5,0,142,8,6,14,"politica.estadao.com.br___noticias_geral,vamos-dar-o-troco-vamos-libertar-o-lula-diz-lider-do-mst,70002256478.txt"
1265,2,1,reforma-trabalhista,estadao,599,4,5,2,456,37,39,78,"politica.estadao.com.br___noticias_geral,veja-as-principais-propostas-de-reforma-politica-na-camara,70001726474.txt"
1266,1,-2,impeachment-dilma,estadao,206,6,4,0,166,10,11,29,"politica.estadao.com.br___noticias_geral,vou-instalar-comissao-do-impeachment-no-dia-seguinte-a-decisao-do-stf--diz-cunha,10000020854.txt"
1267,7,-1,prisao-lula,estadao,140,6,5,1,117,6,13,16,"sao-paulo.estadao.com.br___noticias_geral,oscar-maroni-cumpre-promessa-e-distribui-cerveja-gratis-apos-mandado-de-prisao-de-lula,70002258200.txt"
1268,3,0,reforma-trabalhista,estadao,73,0,0,0,62,1,4,6,"sao-paulo.estadao.com.br___noticias_geral,sindicato-dos-metroviarios-de-sao-paulo-aderem-a-greve-do-dia-30,70001864015.txt"
1269,64,22,impeachment-dilma,veja,1096,14,36,7,896,41,105,111,veja.abril.com.br___blog_felipe-moura-brasil_entenda-por-que-dilma-cometeu-o-crime-das-8220-pedaladas-fiscais-8221-8211-e-fhc-e-lula-nao_.txt
1270,-11,-32,impeachment-dilma,veja,1785,80,48,16,1603,96,85,145,veja.abril.com.br___blog_felipe-moura-brasil_tchau-querida-camara-autoriza-impeachment-de-dilma-vitoria-parcial-contra-a-impunidade_.txt
1271,10,-5,prisao-lula,veja,180,10,5,3,144,10,20,24,veja.abril.com.br___blog_holofote_lula-e-o-brasil-que-vira_.txt
1272,1,3,reforma-trabalhista,veja,226,7,10,0,193,12,13,25,veja.abril.com.br___blog_mailson-da-nobrega_juizes-e-procuradores-do-trabalho-agem-como-no-seculo-xv_.txt
1273,-7,1,soltura-lula,veja,209,7,8,1,176,16,9,24,veja.abril.com.br___blog_maquiavel_a-reacao-da-familia-bolsonaro-a-saida-de-lula-da-cadeia_.txt
1274,-2,-2,afastamento-aecio,veja,217,7,5,2,179,20,18,14,veja.abril.com.br___blog_maquiavel_defesa-divulga-fotos-de-aecio-motoqueiro-para-explicar-audio_.txt
1275,12,8,prisao-lula,veja,268,5,13,1,228,15,27,17,veja.abril.com.br___blog_me-engana-que-eu-posto_lewandowski-nao-pediu-e-julgamento-de-liberdade-de-lula-nao-sera-secreto_.txt
1276,1,-4,prisao-lula,veja,182,7,3,1,149,9,10,25,veja.abril.com.br___blog_parana_com-lula-preso-pt-transfere-sede-para-curitiba_.txt
1277,6,1,soltura-lula,veja,108,1,2,1,81,5,11,15,veja.abril.com.br___blog_radar_maia-anula-ato-de-bolsonarista-por-presidente-argentino-ter-defendido-lula_.txt
1278,1,0,afastamento-aecio,veja,46,2,2,3,39,3,4,7,veja.abril.com.br___blog_radar_tasso-adoraria-que-o-senado-esperasse-stf-decidir-sobre-aecio_.txt
1279,15,3,afastamento-aecio,veja,475,12,15,5,392,29,44,42,veja.abril.com.br___blog_reinaldo_a-verdade-e-que-pobre-brasileiro-e-a-carne-mais-barata-do-mercado_.txt
1280,14,-13,impeachment-dilma,veja,589,33,20,3,468,41,55,81,veja.abril.com.br___blog_reinaldo_planalto-vaza-carta-de-temer-a-dilma-da-tiro-no-proprio-pe-e-esquenta-clima-pro-impeachment_.txt
1281,2,-8,prisao-lula,veja,168,10,2,3,149,10,12,12,veja.abril.com.br___blog_rio-grande-do-sul_lula-foi-preso-antes-do-termino-do-processo-no-trf4-diz-defesa_.txt
1282,-3,-1,reforma-trabalhista,veja,187,7,6,0,145,14,11,30,veja.abril.com.br___blog_rio-grande-do-sul_maia-critica-uso-de-mps-por-temer-instrumento-autoritario_.txt
1283,-4,-6,afastamento-aecio,veja,129,8,2,0,102,11,7,19,veja.abril.com.br___blog_sergio-praca_aecio-tasso-e-a-extrema-esquerda-do-psdb_.txt
1284,-1,-3,afastamento-aecio,veja,209,8,5,2,172,15,14,23,veja.abril.com.br___brasil_a-queda-de-aecio-neves_.txt
1285,-5,-8,afastamento-aecio,veja,234,11,3,1,204,17,12,16,veja.abril.com.br___brasil_aecio-neves-sergio-cabral-e-michel-temer-nas-manchetes-do-dia_.txt
1286,-1,-2,impeachment-dilma,veja,59,2,0,0,53,2,1,5,veja.abril.com.br___brasil_ato-contra-impeachment-termina-em-quebra-quebra-na-paulista_.txt
1287,-8,-31,impeachment-dilma,veja,527,42,11,2,445,40,32,65,veja.abril.com.br___brasil_bolsonaro-nao-representa-quem-defende-o-impeachment_.txt
1288,4,-3,afastamento-aecio,veja,242,8,5,1,190,14,18,34,veja.abril.com.br___brasil_de-volta-ao-brasil-joesley-diz-que-sua-familia-foi-ameacada_.txt
1289,19,-7,afastamento-aecio,veja,360,11,4,2,290,21,40,26,veja.abril.com.br___brasil_defesa-de-temer-analisa-pedir-separacao-de-aecio-em-inquerito_.txt
1290,12,11,afastamento-aecio,veja,249,3,14,0,202,12,24,28,veja.abril.com.br___brasil_delegado-da-pf-diz-que-troca-na-justica-aciona-todos-os-alertas_.txt
1291,-3,1,impeachment-dilma,veja,138,5,6,0,108,11,8,22,veja.abril.com.br___brasil_dilma-comete-gravissimo-equivoco-ao-tratar-impeachment-como-golpe-diz-celso-de-mello_.txt
1292,15,-7,impeachment-dilma,veja,331,11,4,2,271,15,30,32,veja.abril.com.br___brasil_e-um-golpe-diz-vice-procuradora-da-republica-sobre-impeachment_.txt
1293,7,3,reforma-trabalhista,veja,123,1,4,3,97,5,12,17,veja.abril.com.br___brasil_feriado-em-dia-util-pode-ser-transferido-para-sabado_.txt
1294,-3,-7,afastamento-aecio,veja,162,10,3,3,144,8,5,21,veja.abril.com.br___brasil_forca-tarefa-da-lava-jato-se-diz-estarrecida-com-delacao-da-jbs_.txt
1295,0,1,impeachment-dilma,veja,151,2,3,1,111,13,13,20,veja.abril.com.br___brasil_governo-abre-sindicancia-para-investigar-conduta-de-cardozo-no-processo-de-impeachment_.txt
1296,-2,-2,afastamento-aecio,veja,595,16,14,4,488,42,40,59,veja.abril.com.br___brasil_joesley-pedi-ao-aecio-que-parasse-de-me-pedir-dinheiro_.txt
1297,4,-2,reforma-trabalhista,veja,259,7,5,3,188,16,20,50,veja.abril.com.br___brasil_lula-diz-que-golpe-mira-conquistas-sociais-e-pede-povo-na-rua_.txt
1298,10,-3,soltura-lula,veja,193,9,6,1,161,8,18,22,veja.abril.com.br___brasil_lula-encontra-jose-dirceu-em-primeira-noite-de-liberdade_.txt
1299,4,4,afastamento-aecio,veja,470,8,12,6,387,26,30,53,veja.abril.com.br___brasil_mais-exposto-do-que-nunca-stf-foi-palco-de-disputas-politicas_.txt
1300,-19,-6,impeachment-dilma,veja,822,15,9,2,672,46,27,103,veja.abril.com.br___brasil_manifestacoes-pro-e-contra-o-impeachment-ocorrem-em-25-estados-e-no-df_.txt
1301,0,3,afastamento-aecio,veja,187,3,6,2,150,10,10,28,veja.abril.com.br___brasil_mendes-divulgacao-de-fonte-enche-nos-de-vergonha_.txt
1302,2,-9,reforma-trabalhista,veja,403,18,9,2,323,28,30,51,veja.abril.com.br___brasil_o-dilema-do-psdb-ficar-ou-nao-ao-lado-de-temer_.txt
1303,7,-18,impeachment-dilma,veja,1186,36,18,12,941,71,78,162,veja.abril.com.br___brasil_os-ultimos-dias-de-dilma-rousseff_.txt
1304,-4,-9,afastamento-aecio,veja,262,12,3,2,198,24,20,37,veja.abril.com.br___brasil_partidos-articulam-saida-negociada-sem-eleicoes-diretas_.txt
1305,-2,-3,impeachment-dilma,veja,146,5,2,1,125,8,6,15,veja.abril.com.br___brasil_pdt-inicia-processo-de-expulsao-de-deputados-que-votaram-pelo-impeachment_.txt
1306,-8,-3,afastamento-aecio,veja,247,6,3,4,200,18,10,32,veja.abril.com.br___brasil_pf-encontra-recibos-com-inscricao-cx-2-no-apartamento-de-aecio_.txt
1307,4,-6,afastamento-aecio,veja,298,11,5,6,255,18,22,25,veja.abril.com.br___brasil_renan-sobre-aecio-neves-uma-liminar-pode-afastar-um-senador_.txt
1308,-1,-11,reforma-trabalhista,veja,204,20,9,2,172,20,19,24,veja.abril.com.br___brasil_reves-na-reforma-trabalhista-e-duro-golpe-para-um-temer-nas-cordas_.txt
1309,5,-1,afastamento-aecio,veja,368,4,3,0,297,17,22,39,veja.abril.com.br___brasil_saud-revela-caixa-dois-milionario-a-marqueteiro-de-aecio_.txt
1310,-7,-2,impeachment-dilma,veja,151,5,3,2,123,16,9,13,veja.abril.com.br___brasil_senado-nao-vai-frear-impeachment-preve-renan_.txt
1311,0,-2,afastamento-aecio,veja,198,8,6,1,177,12,12,12,veja.abril.com.br___brasil_sequestrado-em-maternidade-pedrinho-e-advogado-de-aecio_.txt
1312,16,0,afastamento-aecio,veja,331,4,4,1,256,23,39,22,veja.abril.com.br___brasil_stf-abre-novo-inquerito-contra-aecio-por-lavagem-de-dinheiro_.txt
1313,3,0,soltura-lula,veja,77,2,2,0,67,3,6,5,veja.abril.com.br___cultura_de-felipe-neto-a-camila-pitanga-celebridades-reagem-a-soltura-de-lula_.txt
1314,10,2,reforma-trabalhista,veja,118,1,3,1,88,6,16,13,veja.abril.com.br___cultura_sbt-deixa-de-exibir-chamadas-simpaticas-a-reformas-de-temer_.txt
1315,0,-1,afastamento-aecio,veja,127,1,0,0,100,6,6,16,veja.abril.com.br___cultura_ticiana-villas-boas-pede-afastamento-das-gravacoes-do-sbt_.txt
1316,-3,-2,prisao-lula,veja,58,3,1,1,49,5,2,7,veja.abril.com.br___cultura_tulio-gadelha-namorado-de-fatima-bernardes-vai-ao-abc-apoiar-lula_.txt
1317,3,0,reforma-previdencia,veja,225,1,1,0,179,8,11,29,veja.abril.com.br___economia_alcolumbre-defende-estados-e-municipios-na-previdencia-em-pec-paralela_.txt
1318,16,8,reforma-previdencia,veja,852,16,24,3,706,32,48,109,veja.abril.com.br___economia_ao-vivo-comissao-especial-vota-relatorio-da-previdencia_.txt
1319,5,4,reforma-previdencia,veja,287,3,7,3,216,20,25,39,veja.abril.com.br___economia_bolsonaro-preve-aprovacao-da-reforma-da-previdencia-ainda-no-1o-semestre_.txt
1320,36,5,reforma-trabalhista,veja,750,9,14,4,602,28,64,83,veja.abril.com.br___economia_camara-aprova-texto-base-da-reforma-trabalhista-veja-o-que-muda_.txt
1321,6,5,reforma-trabalhista,veja,312,5,10,2,261,17,23,28,veja.abril.com.br___economia_camara-rejeita-pedido-de-urgencia-para-reforma-trabalhista_.txt
1322,9,4,reforma-previdencia,veja,253,2,6,0,208,7,16,30,veja.abril.com.br___economia_ccj-da-camara-aprova-parecer-a-favor-da-reforma-da-previdencia_.txt
1323,21,-5,reforma-previdencia,veja,528,10,5,3,421,16,37,72,veja.abril.com.br___economia_ccj-do-senado-aprova-relatorio-da-previdencia-e-texto-vai-ao-plenario_.txt
1324,12,0,reforma-trabalhista,veja,203,4,4,1,176,3,15,18,veja.abril.com.br___economia_centrais-sindicais-farao-paralisacao-na-sexta-contra-reformas_.txt
1325,14,0,reforma-trabalhista,veja,190,1,1,1,128,9,23,33,veja.abril.com.br___economia_centrais-sindicais-querem-regulamentar-contribuicao-assistencial_.txt
1326,25,7,reforma-trabalhista,veja,249,0,7,1,190,5,30,32,veja.abril.com.br___economia_como-a-reforma-trabalhista-altera-negociacoes-com-patroes_.txt
1327,21,7,reforma-trabalhista,veja,438,1,8,2,350,10,31,58,veja.abril.com.br___economia_como-fica-a-folga-de-feriado-apos-a-reforma-tire-suas-duvidas_.txt
1328,-4,-4,reforma-previdencia,veja,401,7,3,3,300,19,15,80,veja.abril.com.br___economia_confira-as-principais-mudancas-da-reforma-da-previdencia_.txt
1329,6,8,reforma-trabalhista,veja,304,7,15,4,241,19,25,45,veja.abril.com.br___economia_demissao-consensual-nao-da-direito-a-seguro-desemprego_.txt
1330,5,4,reforma-previdencia,veja,356,1,5,0,297,11,16,38,veja.abril.com.br___economia_deputados-aprovam-relatorio-da-previdencia-e-texto-vai-a-plenario_.txt
1331,2,-1,reforma-previdencia,veja,158,2,1,1,131,5,7,19,veja.abril.com.br___economia_economia-com-reforma-da-previdencia-cai-para-r-915-bi-diz-relator_.txt
1332,7,4,reforma-previdencia,veja,153,2,6,0,126,5,12,18,veja.abril.com.br___economia_em-votacao-simbolica-ccj-do-senado-aprova-reforma-da-previdencia_.txt
1333,16,6,reforma-trabalhista,veja,199,2,8,0,149,7,23,30,veja.abril.com.br___economia_empresas-criam-grupos-para-discutir-adocao-de-reforma-trabalhista_.txt
1334,5,-1,reforma-trabalhista,veja,154,5,4,0,123,9,14,17,veja.abril.com.br___economia_forca-busca-apoio-para-criar-substituto-do-imposto-sindical_.txt
1335,3,-4,reforma-trabalhista,veja,192,8,4,2,153,9,12,32,veja.abril.com.br___economia_globais-protestam-contra-reforma-trabalhista-no-instagram_.txt
1336,9,4,reforma-previdencia,veja,122,0,4,0,98,1,10,17,veja.abril.com.br___economia_governo-tem-330-votos-para-aprovar-reforma-da-previdencia-diz-onyx_.txt
1337,-3,-4,reforma-trabalhista,veja,77,4,0,0,66,4,1,10,veja.abril.com.br___economia_greve-geral-aeroporto-de-congonhas-funciona-normalmente_.txt
1338,0,-2,reforma-trabalhista,veja,195,4,2,0,166,10,10,15,veja.abril.com.br___economia_greve-geral-trt-proibe-paralisacao-total-de-metro-e-onibus-em-sp_.txt
1339,25,12,reforma-trabalhista,veja,273,4,16,1,214,13,38,29,veja.abril.com.br___economia_juiz-usa-reforma-para-condenar-trabalhador-a-pagar-processo_.txt
1340,10,-4,reforma-previdencia,veja,198,7,3,2,163,7,17,23,veja.abril.com.br___economia_maia-desiste-de-articular-reforma-e-diz-que-nao-sera-mulher-de-malandro_.txt
1341,3,1,reforma-previdencia,veja,156,2,3,3,127,5,8,24,veja.abril.com.br___economia_maia-marca-para-terca-feira-inicio-da-votacao-da-reforma-da-previdencia_.txt
1342,2,-1,reforma-trabalhista,veja,105,1,0,0,90,3,5,8,veja.abril.com.br___economia_maia-se-reune-com-centrais-sindicais-sobre-reforma-da-previdencia_.txt
1343,5,3,reforma-trabalhista,veja,143,2,5,2,109,6,11,26,veja.abril.com.br___economia_muito-vai-se-falar-de-nova-lei-trabalhista-diz-temer_.txt
1344,4,2,reforma-trabalhista,veja,177,2,4,1,141,8,12,23,veja.abril.com.br___economia_nao-ha-data-para-votacao-da-reforma-da-previdencia-diz-maia_.txt
1345,1,5,reforma-trabalhista,veja,119,1,6,2,88,9,10,21,veja.abril.com.br___economia_o-que-muda-com-a-aprovacao-da-reforma-trabalhista_.txt
1346,3,1,reforma-previdencia,veja,37,0,1,0,31,0,3,4,veja.abril.com.br___economia_o-que-muda-na-aposentadoria-com-a-reforma-da-previdencia_.txt
1347,24,7,reforma-previdencia,veja,775,14,21,6,606,27,51,132,veja.abril.com.br___economia_o-que-mudou-e-como-fica-a-reforma-da-previdencia-apos-a-ccj-do-senado_.txt
1348,-7,-1,reforma-trabalhista,veja,231,7,6,5,181,21,14,33,veja.abril.com.br___economia_para-idealizador-reforma-trabalhista-cria-oportunidades_.txt
1349,13,1,reforma-previdencia,veja,147,1,2,1,115,4,17,15,veja.abril.com.br___economia_pec-da-reforma-da-previdencia-ira-gerar-r-876-bi-de-economia-diz-marinho_.txt
1350,5,-1,reforma-trabalhista,veja,143,1,0,1,107,6,11,21,veja.abril.com.br___economia_pilotos-e-comissarios-aprovam-estado-de-greve-contra-reformas_.txt
1351,0,0,reforma-trabalhista,veja,203,2,2,1,151,12,12,33,veja.abril.com.br___economia_previdencia-sindicatos-convocam-greve-geral-para-quarta-feira_.txt
1352,8,3,reforma-previdencia,veja,217,2,5,1,177,8,16,24,veja.abril.com.br___economia_reforma-da-previdencia-e-promulgada-pelo-congresso_.txt
1353,3,-1,reforma-previdencia,veja,207,2,1,2,163,9,12,28,veja.abril.com.br___economia_reforma-da-previdencia-tera-idades-diferentes-para-homens-e-mulheres_.txt
1354,10,9,reforma-trabalhista,veja,167,1,10,0,126,13,23,16,veja.abril.com.br___economia_reforma-empresas-ja-oferecem-vagas-previstas-em-nova-lei_.txt
1355,13,11,reforma-trabalhista,veja,376,5,16,2,285,25,38,51,veja.abril.com.br___economia_reforma-homologacao-da-rescisao-deixa-de-ser-feita-em-sindicatos_.txt
1356,3,17,reforma-trabalhista,veja,625,5,22,4,512,31,34,79,veja.abril.com.br___economia_reforma-maiores-de-50-anos-poderao-parcelar-ferias_.txt
1357,19,10,reforma-trabalhista,veja,288,1,11,2,224,12,31,35,veja.abril.com.br___economia_reforma-nao-acaba-com-demissao-sem-justa-causa_.txt
1358,5,9,reforma-trabalhista,veja,240,1,10,1,194,15,20,23,veja.abril.com.br___economia_reforma-permite-contratacao-de-funcionario-por-r-426-a-hora_.txt
1359,12,10,reforma-trabalhista,veja,159,0,10,2,127,3,15,26,veja.abril.com.br___economia_reforma-preve-que-ferias-possam-ser-determinadas-pelo-empregador_.txt
1360,6,14,reforma-trabalhista,veja,384,5,19,0,298,22,28,60,veja.abril.com.br___economia_reforma-trabalhista-como-fica-a-demissao-consensual_.txt
1361,30,10,reforma-trabalhista,veja,650,7,17,3,490,35,65,87,veja.abril.com.br___economia_reforma-trabalhista-entra-em-vigor-no-dia-11-veja-o-que-muda_.txt
1362,1,1,reforma-trabalhista,veja,115,2,3,2,94,5,6,17,veja.abril.com.br___economia_reforma-trabalhista-lg-quer-modificar-contratos-dos-funcionarios_.txt
1363,9,14,reforma-trabalhista,veja,282,5,19,0,212,24,33,37,veja.abril.com.br___economia_reforma-trabalhista-o-que-muda-nas-acoes-trabalhistas_.txt
1364,6,3,reforma-trabalhista,veja,205,2,5,3,165,8,14,28,veja.abril.com.br___economia_reforma-trabalhista-reduzira-desemprego-em-15-milhao-diz-itau_.txt
1365,3,1,reforma-trabalhista,veja,147,1,2,0,119,4,7,20,veja.abril.com.br___economia_reforma-trabalhista-vai-propor-mudancas-em-100-pontos-da-clt_.txt
1366,7,1,reforma-trabalhista,veja,264,3,4,2,213,8,15,37,veja.abril.com.br___economia_reforma-trabalhista-veja-o-que-muda-com-a-medida-provisoria_.txt
1367,-5,-1,reforma-trabalhista,veja,255,4,3,1,196,11,6,50,veja.abril.com.br___economia_relator-reduz-idade-de-aposentadoria-para-agente-penitenciario_.txt
1368,2,-2,soltura-lula,veja,157,7,5,1,121,9,11,29,veja.abril.com.br___economia_risco-lula-faz-dolar-disparar-e-bater-nos-r-415_.txt
1369,1,0,reforma-trabalhista,veja,134,3,3,0,106,9,10,15,veja.abril.com.br___economia_sem-imposto-sindicato-ameaca-cortar-servico-a-associados_.txt
1370,-5,-2,reforma-previdencia,veja,168,7,5,3,146,15,10,12,veja.abril.com.br___economia_tabata-amaral-e-ameacada-de-expulsao-pelo-pdt-caso-vote-a-favor-da-reforma_.txt
1371,5,-1,reforma-trabalhista,veja,195,3,2,1,160,5,10,26,veja.abril.com.br___economia_temer-sanciona-reforma-trabalhista-sem-falar-em-vetos_.txt
1372,46,16,reforma-trabalhista,veja,683,11,27,1,527,30,76,89,veja.abril.com.br___economia_tire-suas-duvidas-sobre-10-pontos-da-reforma-trabalhista_.txt
1373,0,0,reforma-previdencia,veja,389,7,7,6,304,24,24,57,veja.abril.com.br___economia_trilhao-por-um-triz-reforma-da-previdencia-avanca-na-camara_.txt
1374,8,-2,reforma-previdencia,veja,483,8,6,3,379,16,24,81,veja.abril.com.br___economia_veja-as-novas-regras-da-previdencia-aprovadas-em-primeiro-turno-na-camara_.txt
1375,3,-3,reforma-trabalhista,veja,1105,18,15,12,928,56,59,107,veja.abril.com.br___economia_votacao-reforma-trabalhista-senado-ao-vivo_.txt
1376,6,4,reforma-trabalhista,veja,178,1,5,0,123,8,14,39,veja.abril.com.br___mundo_apesar-de-protestos-macron-assina-reforma-trabalhista-na-franca_.txt
1377,-1,-3,impeachment-dilma,veja,213,5,2,0,168,10,9,33,veja.abril.com.br___mundo_impeachment-de-dilma-repercute-na-imprensa-internacional_.txt
1378,7,-5,soltura-lula,veja,244,10,5,1,209,10,17,24,veja.abril.com.br___mundo_presidente-da-argentina-comemora-decisao-do-stf-lula-livre-amanha_.txt
1379,3,1,soltura-lula,veja,70,2,3,3,53,4,7,14,veja.abril.com.br___podcast_o-efeito-lula-na-politica_.txt
1380,3,6,soltura-lula,veja,222,8,14,1,190,13,16,26,veja.abril.com.br___politica_a-verdade-triunfou-diz-maduro-sobre-soltura-de-lula-veja-repercussao_.txt
1381,-11,-1,impeachment-dilma,veja,187,2,1,3,145,18,7,23,veja.abril.com.br___politica_acusacao-entrega-alegacoes-finais-antes-do-prazo-para-acelerar-impeachment_.txt
1382,10,3,afastamento-aecio,veja,206,4,7,1,171,10,20,17,veja.abril.com.br___politica_aloysio-nunes-critica-fux-por-zombar-de-aecio-em-julgamento_.txt
1383,3,-2,afastamento-aecio,veja,744,26,24,5,640,42,45,72,veja.abril.com.br___politica_ao-vivo-stf-decide-sobre-afastamento-de-parlamentares_.txt
1384,0,-11,prisao-lula,veja,2408,77,66,24,2086,120,120,249,veja.abril.com.br___politica_ao-vivo-stf-julga-habeas-corpus-contra-prisao-de-lula_.txt
1385,20,-21,prisao-lula,veja,1253,52,31,15,1080,76,96,99,veja.abril.com.br___politica_ao-vivo-stf-julga-habeas-corpus-preventivo-de-lula-acompanhe_.txt
1386,-3,-1,afastamento-aecio,veja,117,3,2,3,101,9,6,9,veja.abril.com.br___politica_apos-46-dias-afastado-aecio-neves-retoma-mandato-no-senado_.txt
1387,25,4,reforma-previdencia,veja,1295,27,31,15,994,76,101,197,veja.abril.com.br___politica_aposta-no-tudo-ou-nada_.txt
1388,19,12,impeachment-dilma,veja,507,7,19,6,415,23,42,59,veja.abril.com.br___politica_as-vesperas-da-votacao-do-impeachment-dilma-sofre-dura-derrota-no-stf_.txt
1389,1,-1,soltura-lula,veja,254,11,10,4,212,13,14,40,veja.abril.com.br___politica_bolsonaro-silencia-sobre-soltura-de-lula_.txt
1390,32,-3,reforma-trabalhista,veja,1622,33,30,7,1218,104,136,234,veja.abril.com.br___politica_brasil-em-reforma_.txt
1391,-9,2,impeachment-dilma,veja,604,15,17,7,490,42,33,78,veja.abril.com.br___politica_camara-aprova-processo-de-impeachment-contra-dilma-rousseff_.txt
1392,1,2,impeachment-dilma,veja,267,4,6,2,214,17,18,30,veja.abril.com.br___politica_camara-ja-derrubou-o-governo-diz-cunha_.txt
1393,-4,-4,soltura-lula,veja,370,10,6,1,327,14,10,36,veja.abril.com.br___politica_capitais-registram-protestos-contra-stf-e-liberdade-de-lula_.txt
1394,5,-5,prisao-lula,veja,333,10,5,3,263,24,29,35,veja.abril.com.br___politica_carmen-lucia-decide-receber-advogado-de-lula-para-discutir-prisao_.txt
1395,4,4,afastamento-aecio,veja,116,0,4,2,96,2,6,18,veja.abril.com.br___politica_caso-aecio-fara-parte-de-antologia-de-erros-do-stf-diz-barroso_.txt
1396,2,-3,prisao-lula,veja,134,10,7,0,123,7,9,12,veja.abril.com.br___politica_ciro-gomes-elogia-stf-sobre-liminar-que-impediu-prisao-de-lula_.txt
1397,3,1,impeachment-dilma,veja,205,1,2,0,158,9,12,29,veja.abril.com.br___politica_collor-critica-dois-pesos-e-duas-medidas-para-beneficiar-dilma_.txt
1398,0,-4,soltura-lula,veja,94,4,0,0,82,5,5,6,veja.abril.com.br___politica_com-base-em-decisao-do-stf-juiza-manda-soltar-ex-ministro-jose-dirceu_.txt
1399,0,1,impeachment-dilma,veja,192,1,2,0,187,3,3,2,veja.abril.com.br___politica_confira-o-voto-de-cada-senador-no-impeachment-de-dilma_.txt
1400,-5,-4,impeachment-dilma,veja,216,8,4,0,180,14,9,25,veja.abril.com.br___politica_datafolha-apoio-ao-impeachment-de-dilma-e-rejeicao-de-lula-batem-recorde_.txt
1401,-6,-1,impeachment-dilma,veja,184,2,1,3,150,13,7,20,veja.abril.com.br___politica_defesa-de-dilma-apresenta-recursos-contra-processo-de-impeachment_.txt
1402,2,3,soltura-lula,veja,145,4,7,0,129,8,10,9,veja.abril.com.br___politica_defesa-de-lula-quer-que-marco-aurelio-analise-pedido-de-soltura_.txt
1403,-4,-2,prisao-lula,veja,63,2,0,1,47,8,4,7,veja.abril.com.br___politica_defesa-de-lula-recorre-a-onu-para-evitar-prisao-do-ex-presidente_.txt
1404,7,6,impeachment-dilma,veja,179,2,8,2,142,9,16,24,veja.abril.com.br___politica_defesa-e-acusacao-terao-direito-a-6-testemunhas-cada-diz-lewandowski_.txt
1405,2,-3,soltura-lula,veja,119,6,3,1,92,6,8,23,veja.abril.com.br___politica_deputados-do-psl-pedem-prisao-de-lula-pela-lei-de-seguranca-nacional_.txt
1406,-5,-15,impeachment-dilma,veja,227,21,6,0,197,18,13,26,veja.abril.com.br___politica_dilma-chama-temer-e-cunha-de-chefe-e-vice-chefe-do-golpe_.txt
1407,-5,7,impeachment-dilma,veja,282,11,18,3,221,21,16,56,veja.abril.com.br___politica_dilma-declara-guerra-do-pt-a-temer-e-afirma-nos-voltaremos_.txt
1408,-8,9,impeachment-dilma,veja,228,5,14,2,200,17,9,23,veja.abril.com.br___politica_dilma-e-aecio-frente-a-frente-agora-no-impeachment_.txt
1409,-2,-3,soltura-lula,veja,143,7,4,0,131,8,6,9,veja.abril.com.br___politica_dirceu-e-mais-sete-da-lava-jato-pedem-soltura-eduardo-azeredo-sera-solto_.txt
1410,3,-4,prisao-lula,veja,161,8,4,0,143,6,9,15,veja.abril.com.br___politica_dodge-diz-confiar-em-decisao-do-stf-a-favor-da-prisao-em-2o-grau_.txt
1411,-3,-1,soltura-lula,veja,88,2,1,0,75,6,3,7,veja.abril.com.br___politica_doria-saida-temporaria-de-lula-da-cadeia-nao-anula-os-crimes-que-cometeu_.txt
1412,0,-4,impeachment-dilma,veja,127,6,2,1,104,7,7,18,veja.abril.com.br___politica_e-de-chorar-de-vergonha-diz-joaquim-barbosa-sobre-votacao-do-impeachment-na-camara_.txt
1413,13,5,prisao-lula,veja,147,3,8,1,119,7,20,13,veja.abril.com.br___politica_em-carta-enviada-da-cadeia-lula-se-diz-feliz-com-pesquisa_.txt
1414,-1,-3,prisao-lula,veja,197,9,6,2,170,13,12,19,veja.abril.com.br___politica_em-carta-lula-se-diz-indignado-e-volta-a-desafiar-lava-jato_.txt
1415,-2,-4,impeachment-dilma,veja,111,7,3,0,86,9,7,19,veja.abril.com.br___politica_em-interrogatorio-katia-abreu-faz-defesa-da-gestao-dilma_.txt
1416,2,0,impeachment-dilma,veja,31,0,0,0,25,0,2,4,veja.abril.com.br___politica_entenda-o-passo-a-passo-do-processo-de-impeachment_.txt
1417,3,-12,prisao-lula,veja,327,20,8,7,275,23,26,38,veja.abril.com.br___politica_estou-pronto-para-ser-preso-afirma-lula-em-livro_.txt
1418,3,-4,soltura-lula,veja,211,8,4,0,175,14,17,17,veja.abril.com.br___politica_fachin-sugere-que-2-turma-julgue-liberdade-de-lula-na-proxima-terca_.txt
1419,1,3,impeachment-dilma,veja,228,6,9,1,170,17,18,39,veja.abril.com.br___politica_fatiamento-e-no-minimo-bizarro-diz-mendes-sobre-impeachment_.txt
1420,4,1,impeachment-dilma,veja,153,3,4,0,122,8,12,18,veja.abril.com.br___politica_fhc-agora-o-caminho-e-o-impeachment_.txt
1421,-12,-4,impeachment-dilma,veja,138,5,1,6,109,16,4,21,veja.abril.com.br___politica_filho-de-cabral-e-secretario-de-paes-vao-a-brasilia-votar-contra-dilma_.txt
1422,8,2,reforma-previdencia,veja,145,0,2,0,118,2,10,17,veja.abril.com.br___politica_francischini-votacao-da-reforma-da-previdencia-na-ccj-sera-em-17-de-abril_.txt
1423,1,-4,prisao-lula,veja,74,4,0,1,61,2,3,13,veja.abril.com.br___politica_gleisi-critica-prisao-e-chama-moro-de-juiz-armado-de-odio-e-de-rancor_.txt
1424,4,-1,soltura-lula,veja,262,3,2,2,211,10,14,34,veja.abril.com.br___politica_governo-busca-criador-do-bolsa-familia-para-formular-pacote-social_.txt
1425,-4,-6,impeachment-dilma,veja,419,11,5,3,360,21,17,40,veja.abril.com.br___politica_grampos-revelam-golpe-de-lula-e-dilma-contra-lava-jato-e-multidao-volta-as-ruas_.txt
1426,-1,2,prisao-lula,veja,143,7,9,0,131,7,6,15,veja.abril.com.br___politica_grupo-pede-lula-livre-e-joga-tinta-vermelha-na-entrada-do-stf_.txt
1427,0,-3,prisao-lula,veja,126,4,1,0,106,3,3,19,veja.abril.com.br___politica_haddad-e-a-primeira-visita-de-lula-em-dia-marcado-para-prisao_.txt
1428,11,-2,prisao-lula,veja,213,7,5,13,185,12,23,18,veja.abril.com.br___politica_hc-de-lula-como-votam-os-ministros-do-stf-nomeados-pelo-pt_.txt
1429,4,-3,afastamento-aecio,veja,199,12,9,3,159,14,18,32,veja.abril.com.br___politica_joao-doria-sobre-gravacao-de-aecio-neves-e-estarrecedor_.txt
1430,-6,-7,prisao-lula,veja,328,14,7,0,298,17,11,23,veja.abril.com.br___politica_juiza-nao-permite-entrevistas-e-sabatinas-de-lula-na-prisao_.txt
1431,7,10,soltura-lula,veja,191,2,12,1,161,11,18,16,veja.abril.com.br___politica_juiza-vai-esperar-manifestacao-do-mpf-sobre-soltura-de-lula_.txt
1432,-8,-2,impeachment-dilma,veja,551,18,16,2,448,36,28,75,veja.abril.com.br___politica_lavenere-faz-discurso-do-medo-e-diz-que-impeachment-e-pena-de-morte-de-dilma-e-de-programas-sociais_.txt
1433,2,-1,prisao-lula,veja,166,5,4,3,140,7,9,22,veja.abril.com.br___politica_lei-severa-so-vale-para-um-lado-diz-ciro-sobre-prisao-de-lula_.txt
1434,0,3,impeachment-dilma,veja,171,2,5,2,137,8,8,27,veja.abril.com.br___politica_lewandowski-fatia-votacao-do-impeachment_.txt
1435,-4,0,prisao-lula,veja,210,7,7,1,173,15,11,26,veja.abril.com.br___politica_lula-apresenta-novo-recurso-ao-stf-e-quer-julgamento-na-2a-turma_.txt
1436,-2,-1,prisao-lula,veja,97,3,2,1,85,6,4,8,veja.abril.com.br___politica_lula-chora-ao-gravar-video-que-sera-divulgado-pelo-pt-apos-prisao_.txt
1437,-2,-5,soltura-lula,veja,172,11,6,1,155,10,8,17,veja.abril.com.br___politica_lula-de-volta-as-ruas_.txt
1438,9,-8,prisao-lula,veja,189,14,6,2,159,14,23,15,veja.abril.com.br___politica_lula-diz-que-adversarios-terao-de-arcar-com-preco-de-sua-prisao_.txt
1439,-2,-9,prisao-lula,veja,174,10,1,3,159,9,7,13,veja.abril.com.br___politica_lula-e-moro-ficarao-frente-a-frente-pela-terceira-vez-em-11-de-setembro_.txt
1440,-6,-13,prisao-lula,veja,134,14,1,1,112,13,7,18,veja.abril.com.br___politica_lula-e-o-6o-ex-presidente-preso-no-brasil-e-o-1o-por-crime-comum_.txt
1441,-10,-20,prisao-lula,veja,582,33,13,3,516,38,28,49,veja.abril.com.br___politica_lula-e-preso-ex-presidente-se-entrega-a-policia-federal_.txt
1442,3,-2,prisao-lula,veja,122,5,3,0,111,4,7,8,veja.abril.com.br___politica_lula-ja-esta-cumprindo-pena-diz-ex-ministra_.txt
1443,-7,4,prisao-lula,veja,265,11,15,3,215,24,17,38,veja.abril.com.br___politica_lula-recorre-para-ter-de-volta-assessores-motoristas-e-segurancas_.txt
1444,-1,-11,prisao-lula,veja,249,13,2,0,209,19,18,18,veja.abril.com.br___politica_lula-sera-preso-neste-sabado-apos-missa-de-marisa-diz-petista_.txt
1445,-4,-4,prisao-lula,veja,185,5,1,0,159,13,9,10,veja.abril.com.br___politica_lula-so-sabera-de-julgamento-48-horas-antes-decide-trf4_.txt
1446,6,0,soltura-lula,veja,418,16,16,4,341,31,37,45,veja.abril.com.br___politica_lula-stf-liberdade-lava-jato_.txt
1447,15,-7,prisao-lula,veja,249,14,7,1,214,11,26,20,veja.abril.com.br___politica_lula-vai-receber-advogado-neste-domingo-na-policia-federal_.txt
1448,1,-4,impeachment-dilma,veja,171,5,1,0,144,4,5,24,veja.abril.com.br___politica_manifestantes-saem-as-ruas-em-10-estados-e-no-distrito-federal_.txt
1449,-13,5,soltura-lula,veja,347,9,14,1,314,26,13,18,veja.abril.com.br___politica_ministro-do-stj-nega-pedido-de-lula-para-sustar-acao-do-sitio-de-atibaia_.txt
1450,1,2,prisao-lula,veja,142,1,3,0,115,8,9,14,veja.abril.com.br___politica_moro-impede-que-lula-tenha-esquema-especial-de-visitas-na-pf_.txt
1451,4,2,prisao-lula,veja,214,7,9,0,190,9,13,18,veja.abril.com.br___politica_mpf-pede-a-justica-rejeicao-de-recurso-e-prisao-imediata-de-lula_.txt
1452,0,-4,prisao-lula,veja,57,4,0,0,55,1,1,4,veja.abril.com.br___politica_mst-inicia-bloqueio-de-estradas-no-pais-em-protesto-contra-prisao-de-lula_.txt
1453,2,-9,prisao-lula,veja,95,9,0,0,81,6,8,9,veja.abril.com.br___politica_mtst-invade-o-triplex-no-guaruja-atribuido-a-lula_.txt
1454,2,6,impeachment-dilma,veja,296,9,15,0,245,16,18,41,veja.abril.com.br___politica_na-comissao-do-impeachment-juristas-acusam-dilma-sobram-crimes-de-responsabilidade_.txt
1455,-8,-11,soltura-lula,veja,349,17,6,2,280,32,24,38,veja.abril.com.br___politica_nao-sou-ladrao-nem-pombo-correio-diz-lula-sobre-tornozeleira-eletronica_.txt
1456,-7,3,reforma-previdencia,veja,297,8,11,3,245,23,16,35,veja.abril.com.br___politica_negociacoes-na-ccj-podem-tirar-temas-da-reforma-da-previdencia-veja-quais_.txt
1457,9,-4,impeachment-dilma,veja,630,24,20,4,540,28,37,73,veja.abril.com.br___politica_no-planalto-dilma-faz-discurso-de-militante-nao-vai-ter-golpe_.txt
1458,-1,-4,prisao-lula,veja,128,5,1,2,109,7,6,14,veja.abril.com.br___politica_o-plano-da-policia-federal-para-o-dia-da-prisao-de-lula_.txt
1459,9,-2,prisao-lula,veja,309,9,7,2,250,12,21,44,veja.abril.com.br___politica_onu-rejeita-liminar-para-pedir-ao-brasil-que-tire-lula-da-prisao_.txt
1460,4,4,prisao-lula,veja,150,4,8,2,135,5,9,15,veja.abril.com.br___politica_para-51-dos-brasileiros-condenacao-de-lula-foi-justa-indica-pesquisa_.txt
1461,-6,-5,prisao-lula,veja,265,12,7,0,209,24,18,33,veja.abril.com.br___politica_partido-quer-desistir-de-liminar-no-stf-que-pode-soltar-lula-diz-lider_.txt
1462,-5,-10,reforma-previdencia,veja,913,27,17,4,718,57,52,134,veja.abril.com.br___politica_peco-ao-presidente-que-pare_.txt
1463,11,9,prisao-lula,veja,191,6,15,1,155,9,20,29,veja.abril.com.br___politica_petistas-celebram-decisao-do-supremo-que-impede-prisao-de-lula_.txt
1464,-3,-1,prisao-lula,veja,82,2,1,1,71,5,2,8,veja.abril.com.br___politica_pf-em-curitiba-diz-que-negociacao-sobre-prisao-nao-esta-definida_.txt
1465,-2,-11,impeachment-dilma,veja,319,14,3,6,247,25,23,47,veja.abril.com.br___politica_pp-anuncia-maioria-contra-dilma-e-desembarca-do-governo_.txt
1466,-8,0,impeachment-dilma,veja,179,6,6,1,151,15,7,19,veja.abril.com.br___politica_prb-decide-votar-pelo-impeachment-de-dilma_.txt
1467,0,-8,prisao-lula,veja,240,11,3,1,198,16,16,25,veja.abril.com.br___politica_presidente-do-stj-nega-habeas-corpus-a-lula-e-critica-favreto_.txt
1468,8,-6,prisao-lula,veja,349,17,11,1,287,22,30,39,veja.abril.com.br___politica_preso-ha-100-dias-lula-mantem-pt-imobilizado-para-as-eleicoes_.txt
1469,-12,-5,prisao-lula,veja,377,10,5,0,319,23,11,39,veja.abril.com.br___politica_prisao-de-lula-absorve-atos-de-1o-de-maio-e-unifica-centrais-sindicais_.txt
1470,4,-1,soltura-lula,veja,154,6,5,0,137,7,11,10,veja.abril.com.br___politica_procuradores-da-lava-jato-pedem-que-lula-cumpra-pena-no-semiaberto_.txt
1471,-9,-6,prisao-lula,veja,261,13,7,0,220,23,14,24,veja.abril.com.br___politica_pt-ve-possibilidade-de-prisao-de-lula-antes-da-pascoa_.txt
1472,-5,0,impeachment-dilma,veja,81,3,3,0,68,8,3,8,veja.abril.com.br___politica_quatro-caminhoes-fazem-mudanca-de-dilma-para-porto-alegre_.txt
1473,3,-1,prisao-lula,veja,152,6,5,0,130,8,11,14,veja.abril.com.br___politica_relator-do-caso-no-trf4-gebran-neto-determina-que-lula-nao-seja-solto_.txt
1474,-2,2,impeachment-dilma,veja,189,3,5,1,157,10,8,23,veja.abril.com.br___politica_renan-intervencao-contra-indiciamento-de-gleisi-foi-transparente_.txt
1475,7,10,impeachment-dilma,veja,366,5,15,1,292,19,26,50,veja.abril.com.br___politica_renan-rejeita-brincadeira-de-maranhao-e-da-sequencia-ao-impeachment_.txt
1476,2,-4,soltura-lula,veja,203,9,5,0,170,14,16,17,veja.abril.com.br___politica_segunda-turma-do-stf-vai-julgar-liberdade-de-lula-na-proxima-terca_.txt
1477,-12,-10,impeachment-dilma,veja,443,19,9,1,364,35,23,50,veja.abril.com.br___politica_senado-afasta-dilma-do-planalto-e-interrompe-o-projeto-de-poder-petista_.txt
1478,-15,-5,impeachment-dilma,veja,816,25,20,1,650,55,40,117,veja.abril.com.br___politica_senado-encerra-mandato-de-dilma-e-fecha-ciclo-de-poder-do-pt_.txt
1479,3,-4,soltura-lula,veja,380,13,9,1,325,19,22,37,veja.abril.com.br___politica_stf-analisa-pedido-de-liberdade-de-lula-e-decide-se-moro-foi-parcial_.txt
1480,6,-13,afastamento-aecio,veja,334,19,6,3,280,30,36,16,veja.abril.com.br___politica_stf-decide-hoje-prisao-preventiva-de-aecio-neves_.txt
1481,0,1,soltura-lula,veja,477,9,10,3,416,28,28,27,veja.abril.com.br___politica_stf-decide-manter-lula-preso-ate-julgamento-de-suspeicao-de-moro_.txt
1482,-32,-29,soltura-lula,veja,1799,80,51,15,1495,124,92,234,veja.abril.com.br___politica_stf-retoma-julgamento-sobre-prisao-em-segunda-instancia-2_.txt
1483,17,-8,soltura-lula,veja,527,25,17,5,445,31,48,50,veja.abril.com.br___politica_stf-veta-prisao-apos-2a-instancia-e-abre-caminho-para-a-soltura-de-lula_.txt
1484,-2,-5,prisao-lula,veja,222,10,5,0,182,14,12,29,veja.abril.com.br___politica_stj-julga-nesta-terca-pedido-de-lula-para-evitar-prisao_.txt
1485,0,1,prisao-lula,veja,66,3,4,0,55,7,7,4,veja.abril.com.br___politica_stj-nega-habeas-corpus-para-impedir-prisao-de-lula_.txt
1486,-6,3,impeachment-dilma,veja,141,1,4,0,112,10,4,20,veja.abril.com.br___politica_suco-de-maracuja-na-comissao-do-impeachment_.txt
1487,0,1,impeachment-dilma,veja,148,4,5,1,129,7,7,15,veja.abril.com.br___politica_supremo-decide-nesta-quarta-o-rito-do-impeachment_.txt
1488,5,1,impeachment-dilma,veja,171,3,4,1,143,7,12,17,veja.abril.com.br___politica_teori-autoriza-inquerito-contra-dilma-por-obstrucao-de-justica_.txt
1489,9,14,impeachment-dilma,veja,289,1,15,1,222,17,26,41,veja.abril.com.br___politica_teori-nega-acao-em-que-dilma-queria-anular-votacao-do-impeachment_.txt
1490,-2,-1,prisao-lula,veja,90,5,4,1,82,6,4,8,veja.abril.com.br___politica_trf4-autoriza-sergio-moro-a-mandar-prender-lula_.txt
1491,0,-7,prisao-lula,veja,201,8,1,2,176,10,10,16,veja.abril.com.br___politica_trf4-rejeita-por-unanimidade-embargos-de-declaracao-de-lula_.txt
1492,-1,-1,afastamento-aecio,veja,311,2,1,0,286,6,5,17,veja.abril.com.br___politica_veja-como-votou-cada-senador-sobre-afastamento-de-aecio-neves_.txt
1493,0,-2,soltura-lula,veja,121,4,2,1,105,7,7,9,veja.abril.com.br___tecnologia_twitter-desde-a-soltura-quase-70-dos-posts-foram-desfavoraveis-a-lula_.txt
1494,16,2,reforma-trabalhista,folha,285,7,9,3,208,16,32,48,www1.folha.uol.com.br___colunas_laura-carvalho_2017_04_1878808-reforma-trabalhista-nao-responde-aos-desafios-do-seculo-21.shtml.txt
1495,7,-1,afastamento-aecio,folha,205,3,2,5,169,11,18,17,www1.folha.uol.com.br___colunas_monicabergamo_2017_05_1885865-senado-pode-desobedecer-decisao-do-stf-e-manter-aecio-no-cargo.shtml.txt
1496,10,2,reforma-trabalhista,folha,332,11,13,3,284,13,23,39,www1.folha.uol.com.br___colunas_monicabergamo_2017_06_1894533-renan-lidera-derrota-do-governo-em-votacao-de-reforma-trabalhista.shtml.txt
1497,1,6,prisao-lula,folha,275,3,9,0,224,19,20,24,www1.folha.uol.com.br___colunas_monicabergamo_2018_04_pf-pede-transferencia-de-lula-e-diz-que-ja-gastou-r-150-mil-com-prisao.shtml.txt
1498,-12,-35,prisao-lula,folha,1594,69,34,10,1287,110,98,212,www1.folha.uol.com.br___ilustrissima_2018_04_pessimista-com-judiciario-lula-planejou-todos-os-passos-de-sua-prisao.shtml.txt
1499,3,5,reforma-trabalhista,folha,232,1,6,3,191,12,15,24,www1.folha.uol.com.br___mercado_2017_03_1864822-justica-do-trabalho-nao-deveria-nem-existir-diz-deputado-rodrigo-maia.shtml.txt
1500,2,-5,reforma-trabalhista,folha,264,8,3,2,227,10,12,28,www1.folha.uol.com.br___mercado_2017_03_1866885-golpe-foi-para-acabar-com-conquistas-da-classe-trabalhadora-diz-lula-em-sp.shtml.txt
1501,23,5,reforma-trabalhista,folha,360,1,6,6,284,11,34,44,www1.folha.uol.com.br___mercado_2017_04_1874946-ferias-poderao-ser-divididas-em-3-periodos-propoe-reforma-trabalhista.shtml.txt
1502,2,-3,reforma-trabalhista,folha,125,4,1,2,101,7,9,15,www1.folha.uol.com.br___mercado_2017_04_1874990-apos-lista-vice-da-camara-defende-que-temer-retire-reforma-da-previdencia.shtml.txt
1503,4,0,reforma-trabalhista,folha,82,1,1,0,75,1,5,3,www1.folha.uol.com.br___mercado_2017_04_1876738-entenda-a-proposta-de-reforma-da-previdencia-apresentada-pelo-relator.shtml.txt
1504,-4,-10,reforma-trabalhista,folha,172,11,1,1,145,11,7,22,www1.folha.uol.com.br___mercado_2017_04_1877069-apos-pressao-24-deputados-mudam-o-voto-na-reforma-trabalhista.shtml.txt
1505,6,3,reforma-trabalhista,folha,258,1,4,0,200,9,15,39,www1.folha.uol.com.br___mercado_2017_04_1878658-centrais-discutem-alternativas-para-fim-do-imposto-sindical.shtml.txt
1506,2,-2,reforma-trabalhista,folha,113,3,1,0,95,3,5,14,www1.folha.uol.com.br___mercado_2017_04_1878758-nao-a-essa-desgraca-diz-erundina-em-protesto-contra-reforma-trabalhista.shtml.txt
1507,6,16,reforma-trabalhista,folha,300,2,18,3,263,6,12,42,www1.folha.uol.com.br___mercado_2017_04_1878784-74-das-industrias-de-sp-sabe-pouco-ou-nada-sobre-reforma-trabalhista.shtml.txt
1508,4,-2,reforma-trabalhista,folha,429,4,2,3,346,20,24,48,www1.folha.uol.com.br___mercado_2017_04_1878976-plenario-da-camara-aprova-texto-base-da-reforma-trabalhista.shtml.txt
1509,7,1,reforma-trabalhista,folha,406,4,5,0,346,12,19,38,www1.folha.uol.com.br___mercado_2017_05_1880026-71-dos-brasileiros-sao-contra-reforma-da-previdencia-mostra-datafolha.shtml.txt
1510,15,-1,reforma-trabalhista,folha,345,4,3,1,263,8,23,59,www1.folha.uol.com.br___mercado_2017_05_1880127-greve-foi-so-o-comeco-diz-paulinho-da-forca-em-ato-de-1-de-maio.shtml.txt
1511,7,-2,reforma-trabalhista,folha,287,5,3,1,211,20,27,38,www1.folha.uol.com.br___mercado_2017_05_1880224-governo-discute-adiar-votacao-da-reforma-da-previdencia.shtml.txt
1512,9,-4,reforma-trabalhista,folha,303,6,2,1,238,15,24,35,www1.folha.uol.com.br___mercado_2017_05_1881383-economia-nao-depende-so-da-reforma-previdencia-diz-fhc.shtml.txt
1513,8,-1,reforma-trabalhista,folha,281,5,4,3,228,10,18,37,www1.folha.uol.com.br___mercado_2017_05_1881982-temer-tenta-acelerar-tramitacao-da-reforma-trabalhista-no-senado.shtml.txt
1514,0,-5,reforma-trabalhista,folha,337,9,4,4,275,23,23,33,www1.folha.uol.com.br___mercado_2017_05_1882146-em-dissonancia-com-cupula-da-cnbb-arcebispo-de-sp-defende-reformas.shtml.txt
1515,7,-5,reforma-trabalhista,folha,295,13,8,1,236,22,29,30,www1.folha.uol.com.br___mercado_2017_05_1887149-empresarios-elevam-pressao-por-reformas-previdenciaria-e-trabalhista.shtml.txt
1516,6,-1,reforma-trabalhista,folha,149,2,1,0,129,4,10,9,www1.folha.uol.com.br___mercado_2017_05_1888611-reforma-trabalhista-sera-aprovada-no-senado-nesta-semana-diz-ministro.shtml.txt
1517,10,6,reforma-trabalhista,folha,703,4,10,4,585,26,36,74,www1.folha.uol.com.br___mercado_2017_06_1890098-reforma-ameaca-aposentadoria-dos-menos-escolarizados.shtml.txt
1518,14,0,reforma-trabalhista,folha,459,9,9,3,385,17,31,47,www1.folha.uol.com.br___mercado_2017_06_1890715-comissao-aprova-texto-da-reforma-trabalhista-e-projeto-avanca-no-senado.shtml.txt
1519,38,-1,reforma-trabalhista,folha,785,20,19,8,629,39,77,87,www1.folha.uol.com.br___mercado_2017_06_1893991-reforma-trabalhista-vai-por-sindicatos-em-guerra-diz-lider-de-metalurgicos.shtml.txt
1520,-1,-5,reforma-trabalhista,folha,231,8,3,0,202,11,10,19,www1.folha.uol.com.br___mercado_2017_06_1894669-apos-derrota-do-governo-reforma-trabalhista-avanca-no-senado.shtml.txt
1521,27,1,reforma-trabalhista,folha,304,6,7,4,238,10,37,36,www1.folha.uol.com.br___mercado_2017_06_1896861-reforma-trabalhista-deve-recuar-em-autonomos-gestantes-e-indenizacao.shtml.txt
1522,-2,-3,reforma-trabalhista,folha,185,3,0,0,147,8,6,27,www1.folha.uol.com.br___mercado_2017_07_1900096-para-mpt-oab-e-cnbb-reforma-trabalhista-viola-a-constituicao.shtml.txt
1523,-3,-11,reforma-trabalhista,folha,476,12,1,1,396,27,24,43,www1.folha.uol.com.br___mercado_2017_07_1900401-apos-muita-confusao-senado-aprova-reforma-trabalhista-de-temer.shtml.txt
1524,32,39,reforma-trabalhista,folha,865,26,65,6,683,51,83,145,www1.folha.uol.com.br___mercado_2017_07_1900464-veja-o-que-muda-para-empresarios-e-empregados-com-a-reforma-trabalhista.shtml.txt
1525,42,13,reforma-trabalhista,folha,740,6,19,3,589,33,75,71,www1.folha.uol.com.br___mercado_2017_07_1900472-nunca-houve-desmonte-tao-grande-dos-direitos-trabalhistas-diz-economista.shtml.txt
1526,13,2,reforma-trabalhista,folha,274,3,5,1,226,7,20,30,www1.folha.uol.com.br___mercado_2017_07_1900487-para-empresario-reforma-vai-reduzir-acoes-sindicato-ve-queda-de-salarios.shtml.txt
1527,17,-6,reforma-trabalhista,folha,386,14,8,0,311,18,35,44,www1.folha.uol.com.br___mercado_2017_07_1900499-maia-vai-barrar-medida-provisoria-de-temer-que-ajusta-reforma-trabalhista.shtml.txt
1528,10,7,reforma-trabalhista,folha,305,0,7,1,242,12,22,37,www1.folha.uol.com.br___mercado_2017_07_1903057-com-reforma-trabalhador-pode-ter-que-pagar-custos-de-processos-atuais.shtml.txt
1529,6,0,reforma-trabalhista,folha,212,10,10,1,186,8,14,25,www1.folha.uol.com.br___mercado_2017_07_1904055-reforma-trabalhista-reforca-multa-por-ma-fe-em-processos-judiciais.shtml.txt
1530,8,-3,reforma-trabalhista,folha,280,7,4,0,229,9,17,36,www1.folha.uol.com.br___mercado_2017_08_1906655-empresas-buscam-substituir-mao-de-obra-por-terceirizados-e-autonomos.shtml.txt
1531,-3,3,reforma-trabalhista,folha,320,3,6,0,256,18,15,40,www1.folha.uol.com.br___mercado_2017_10_1923788-reforma-trabalhista-brasileira-desanima-investidores-nos-eua.shtml.txt
1532,5,2,reforma-trabalhista,folha,238,1,3,0,184,17,22,19,www1.folha.uol.com.br___mercado_2017_10_1928587-empresas-mostram-receio-em-adotar-mudancas-da-reforma-trabalhista.shtml.txt
1533,13,2,reforma-trabalhista,folha,321,5,7,3,239,17,30,50,www1.folha.uol.com.br___mercado_2017_10_1931318-justica-do-trabalho-e-lenta-e-pouco-efetiva-para-o-empregado.shtml.txt
1534,32,10,reforma-trabalhista,folha,762,14,24,1,605,37,69,90,www1.folha.uol.com.br___mercado_2017_11_1933111-e-preciso-flexibilizar-direitos-sociais-para-haver-emprego-diz-chefe-do-tst.shtml.txt
1535,2,-2,reforma-trabalhista,folha,221,5,3,0,184,10,12,23,www1.folha.uol.com.br___mercado_2017_11_1933968-divididos-sindicatos-marcam-protesto-contra-reforma-trabalhista-nesta-sexta.shtml.txt
1536,72,20,reforma-trabalhista,folha,1046,21,41,5,842,41,113,117,www1.folha.uol.com.br___mercado_2017_11_1934569-o-que-muda-com-a-nova-lei-trabalhista.shtml.txt
1537,-3,4,reforma-trabalhista,folha,184,0,4,2,153,8,5,24,www1.folha.uol.com.br___mercado_2017_11_1934725-veja-as-principais-mudancas-de-leis-trabalhistas-desde-a-criacao-da-clt.shtml.txt
1538,-1,2,reforma-trabalhista,folha,251,4,6,2,215,15,14,19,www1.folha.uol.com.br___mercado_2017_11_1934757-vamos-colocar-a-lei-em-pratica-imediatamente-diz-dono-da-riachuelo.shtml.txt
1539,8,3,reforma-trabalhista,folha,306,5,8,4,245,16,24,38,www1.folha.uol.com.br___mercado_2017_11_1935703-mp-da-reforma-trabalhista-proibe-seguro-desemprego-a-intermitente.shtml.txt
1540,11,-3,reforma-trabalhista,folha,252,7,4,0,208,13,24,18,www1.folha.uol.com.br___mercado_2017_11_1936350-cut-lanca-programa-de-demissao-e-funcionarios-ameacam-greve.shtml.txt
1541,0,4,reforma-trabalhista,folha,281,1,5,0,209,22,22,34,www1.folha.uol.com.br___mercado_2017_11_1937178-carteira-de-trabalho-digital-agiliza-solicitacao-de-seguro-desemprego.shtml.txt
1542,17,2,reforma-trabalhista,folha,247,3,5,2,205,6,23,23,www1.folha.uol.com.br___mercado_2017_11_1937583-abertura-de-acoes-trabalhistas-cai-91-apos-reforma-em-sao-paulo.shtml.txt
1543,3,8,reforma-trabalhista,folha,215,2,10,1,166,13,16,33,www1.folha.uol.com.br___mercado_2017_11_1937585-nova-reforma-da-previdencia-e-black-friday-de-direitos-diz-forca.shtml.txt
1544,14,3,prisao-lula,folha,443,10,13,0,366,18,32,50,www1.folha.uol.com.br___mercado_2018_04_dolar-fecha-a-r-342-e-bate-maior-valor-desde-dezembro-de-2016-com-politica.shtml.txt
1545,5,1,reforma-previdencia,folha,188,4,5,1,139,11,16,32,www1.folha.uol.com.br___mercado_2019_02_ao-entregar-reforma-bolsonaro-diz-que-errou-no-passado-ao-votar-contra-mudancas-na-aposentadoria.shtml.txt
1546,7,7,reforma-previdencia,folha,559,4,11,2,438,24,31,83,www1.folha.uol.com.br___mercado_2019_02_definicao-sobre-idade-minima-na-reforma-da-previdencia-sera-de-bolsonaro.shtml.txt
1547,10,6,reforma-previdencia,folha,1137,5,11,5,970,22,32,134,www1.folha.uol.com.br___mercado_2019_02_entenda-os-principais-pontos-da-reforma-da-previdencia.shtml.txt
1548,13,-4,reforma-previdencia,folha,275,9,5,0,216,9,22,42,www1.folha.uol.com.br___mercado_2019_02_meta-e-garantir-ate-330-votos-a-favor-da-reforma-da-previdencia-em-dois-meses-diz-maia.shtml.txt
1549,21,-2,reforma-previdencia,folha,426,6,4,1,317,16,37,67,www1.folha.uol.com.br___mercado_2019_02_reforma-tira-da-constituicao-regras-da-previdencia-social.shtml.txt
1550,14,-7,reforma-previdencia,folha,452,16,9,5,359,25,39,59,www1.folha.uol.com.br___mercado_2019_03_contra-bolsonaro-centrao-quer-resgatar-reforma-da-previdencia-de-temer.shtml.txt
1551,-5,-5,reforma-previdencia,folha,454,11,6,1,354,29,24,65,www1.folha.uol.com.br___mercado_2019_03_maia-muda-o-tom-politico-na-defesa-da-reforma-da-previdencia.shtml.txt
1552,4,3,reforma-previdencia,folha,283,3,6,1,208,22,26,37,www1.folha.uol.com.br___mercado_2019_04_governo-ainda-precisa-fazer-calculos-para-divulgar-impactos-da-reforma-da-previdencia-diz-secretario.shtml.txt
1553,10,3,reforma-previdencia,folha,260,1,4,2,192,13,23,39,www1.folha.uol.com.br___mercado_2019_05_empresarios-consideram-previdencia-aprovada-e-pedem-novas-reformas.shtml.txt
1554,-5,5,reforma-previdencia,folha,329,5,10,1,274,17,12,42,www1.folha.uol.com.br___mercado_2019_05_na-camara-guedes-diz-que-15-mais-ricos-concentram-47-da-previdencia.shtml.txt
1555,2,3,reforma-previdencia,folha,297,2,5,0,245,13,15,31,www1.folha.uol.com.br___mercado_2019_06_25-governadores-pedem-que-reforma-da-previdencia-atinja-estados.shtml.txt
1556,14,1,reforma-previdencia,folha,502,11,12,7,400,27,41,64,www1.folha.uol.com.br___mercado_2019_06_camara-lidera-reforma-da-previdencia-mas-governo-tem-que-ajudar-diz-relator.shtml.txt
1557,12,5,reforma-previdencia,folha,297,3,8,0,231,8,20,49,www1.folha.uol.com.br___mercado_2019_06_contra-previdencia-centrais-preparam-greve-geral-e-prometem-parar-transportes-na-sexta.shtml.txt
1558,5,5,reforma-previdencia,folha,231,0,5,0,192,8,13,23,www1.folha.uol.com.br___mercado_2019_06_economia-com-reforma-da-previdencia-pode-cair-a-r-850-bi-em-dez-anos.shtml.txt
1559,8,0,reforma-previdencia,folha,170,3,3,1,131,7,15,24,www1.folha.uol.com.br___mercado_2019_06_mesmo-com-liminar-suspendendo-greve-no-metro-e-cptm-sindicatos-reafirmam-paralisacao.shtml.txt
1560,5,-1,reforma-previdencia,folha,255,4,3,0,206,12,17,27,www1.folha.uol.com.br___mercado_2019_06_por-apoio-de-ruralistas-reforma-da-previdencia-deve-manter-isencao-a-exportacao-e-poupar-trabalhador-rural.shtml.txt
1561,24,10,reforma-previdencia,folha,347,1,11,4,272,6,30,55,www1.folha.uol.com.br___mercado_2019_06_servidor-homem-ate-escapa-da-reforma-da-previdencia-mulher-nao.shtml.txt
1562,4,4,reforma-previdencia,folha,357,4,8,2,301,15,19,36,www1.folha.uol.com.br___mercado_2019_07_com-sinais-favoraveis-a-aprovacao-camara-deve-votar-reforma-da-previdencia-nesta-4a.shtml.txt
1563,20,15,reforma-previdencia,folha,344,3,18,4,270,14,34,51,www1.folha.uol.com.br___mercado_2019_07_maia-quer-votar-previdencia-na-proxima-semana-e-diz-que-resultado-vai-surpreender.shtml.txt
1564,13,4,reforma-previdencia,folha,447,4,8,3,363,16,29,54,www1.folha.uol.com.br___mercado_2019_07_por-36-a-13-texto-base-da-reforma-da-previdencia-e-aprovada-na-comissao-especial.shtml.txt
1565,6,-2,reforma-previdencia,folha,167,2,0,0,128,8,14,19,www1.folha.uol.com.br___mercado_2019_07_psl-muda-de-posicao-e-apresenta-proposta-para-desidratar-previdencia.shtml.txt
1566,5,1,reforma-previdencia,folha,177,5,6,0,141,7,12,28,www1.folha.uol.com.br___mercado_2019_07_veja-os-pontos-ja-aprovados-que-suavizam-a-reforma-da-previdencia.shtml.txt
1567,20,21,reforma-previdencia,folha,611,2,23,6,498,20,40,84,www1.folha.uol.com.br___mercado_2019_08_camara-conclui-votacao-da-reforma-da-previdencia-proposta-segue-para-o-senado.shtml.txt
1568,14,-1,reforma-previdencia,folha,730,21,20,10,559,55,69,98,www1.folha.uol.com.br___mercado_2019_08_quanto-mais-calado-bolsonaro-ficar-mais-facil-se-aprova-a-previdencia-diz-tasso-jereissati.shtml.txt
1569,39,12,reforma-previdencia,folha,674,2,14,4,505,22,61,106,www1.folha.uol.com.br___mercado_2019_08_reforma-pode-ser-melhor-que-regra-atual-para-parte-dos-trabalhadores.shtml.txt
1570,-6,1,reforma-previdencia,folha,373,3,4,3,296,25,19,43,www1.folha.uol.com.br___mercado_2019_09_senado-apresenta-mais-de-460-emendas-a-reforma-da-previdencia-superando-a-camara.shtml.txt
1571,-5,-1,reforma-previdencia,folha,381,8,7,4,313,23,18,46,www1.folha.uol.com.br___mercado_2019_10_crise-com-o-congresso-ameaca-reforma-da-previdencia.shtml.txt
1572,7,6,reforma-previdencia,folha,189,0,6,0,164,7,14,10,www1.folha.uol.com.br___mercado_2019_10_saiba-como-fica-o-desconto-do-inss-no-salario-apos-a-reforma-da-previdencia.shtml.txt
1573,24,13,reforma-previdencia,folha,570,3,16,4,444,21,45,83,www1.folha.uol.com.br___mercado_2019_10_senado-conclui-aprovacao-da-reforma-da-previdencia-novas-regras-entram-em-vigor-apos-promulgacao.shtml.txt
1574,7,7,reforma-previdencia,folha,415,7,14,0,319,21,28,68,www1.folha.uol.com.br___mercado_2019_10_sob-protestos-comissao-conclui-votacao-da-reforma-da-previdencia-dos-militares.shtml.txt
1575,6,-3,soltura-lula,folha,353,9,6,6,281,20,26,47,www1.folha.uol.com.br___mercado_2019_11_bolsa-e-dolar-ensaiam-recuperacao-pos-efeito-lula.shtml.txt
1576,4,5,reforma-previdencia,folha,303,2,7,3,243,14,18,40,www1.folha.uol.com.br___mercado_2019_11_congresso-promulga-nova-previdencia-que-comeca-a-valer-a-partir-da-publicacao-oficial.shtml.txt
1577,-3,-8,soltura-lula,folha,310,15,7,3,254,17,14,50,www1.folha.uol.com.br___mercado_2019_11_dolar-tem-maior-alta-semanal-desde-agosto-de-2018-com-soltura-de-lula.shtml.txt
1578,5,5,reforma-previdencia,folha,333,3,8,1,271,14,19,41,www1.folha.uol.com.br___mercado_2019_11_maia-ve-cenario-dificil-para-pec-paralela-da-previdencia-na-camara.shtml.txt
1579,10,7,reforma-previdencia,folha,277,2,9,2,221,11,21,37,www1.folha.uol.com.br___mercado_2019_11_reforma-da-previdencia-sera-promulgada-na-terca-diz-alcolumbre.shtml.txt
1580,-7,1,impeachment-dilma,folha,206,3,4,1,167,15,8,24,www1.folha.uol.com.br___mundo_2016_05_1770475-jornais-internacionais-repercutem-o-afastamento-de-dilma-rousseff.shtml.txt
1581,3,-7,prisao-lula,folha,356,29,22,3,287,27,30,66,www1.folha.uol.com.br___opiniao_2018_04_guilherme-boulos-e-manuela-davila-um-atentado-a-democracia.shtml.txt
1582,-4,5,impeachment-dilma,folha,499,11,16,7,421,31,27,54,www1.folha.uol.com.br___poder_2016_03_1752791-tenho-certeza-de-que-nao-vai-ter-golpe-diz-dilma.shtml.txt
1583,1,-5,impeachment-dilma,folha,400,11,6,3,297,22,23,78,www1.folha.uol.com.br___poder_2016_03_1754357-dilma-teme-que-pp-pr-e-psd-sigam-pmdb-na-debandada-do-governo.shtml.txt
1584,1,10,impeachment-dilma,folha,417,6,16,1,327,25,26,62,www1.folha.uol.com.br___poder_2016_03_1755585-impeachment-sem-crime-de-responsabilidade-e-golpe-diz-dilma.shtml.txt
1585,9,-3,impeachment-dilma,folha,415,9,6,6,348,19,28,41,www1.folha.uol.com.br___poder_2016_04_1757067-em-resposta-a-editorial-da-folha-dilma-diz-que-jamais-renunciara.shtml.txt
1586,6,2,impeachment-dilma,folha,414,5,7,6,325,28,34,45,www1.folha.uol.com.br___poder_2016_04_1758777-na-camara-60-dizem-votar-pelo-impeachment-de-dilma-rousseff.shtml.txt
1587,16,-16,impeachment-dilma,folha,524,23,7,2,422,25,41,68,www1.folha.uol.com.br___poder_2016_04_1759725-temer-divulga-audio-em-que-fala-como-se-impeachment-estivesse-aprovado.shtml.txt
1588,1,1,impeachment-dilma,folha,150,2,3,1,119,11,12,14,www1.folha.uol.com.br___poder_2016_04_1760702-lula-diz-que-nao-saira-das-ruas-se-dilma-for-derrotada-em-impeachment.shtml.txt
1589,-3,2,impeachment-dilma,folha,372,3,5,4,319,17,14,34,www1.folha.uol.com.br___poder_2016_04_1760735-apos-adesao-do-psd-ao-impeachment-de-dilma-oposicao-ja-fala-em-vitoria.shtml.txt
1590,-3,1,impeachment-dilma,folha,398,6,7,1,310,24,21,57,www1.folha.uol.com.br___poder_2016_04_1760873-aliados-de-dilma-divulgam-lista-de-deputados-contrarios-a-impeachment.shtml.txt
1591,5,5,impeachment-dilma,folha,178,3,8,0,146,12,17,14,www1.folha.uol.com.br___poder_2016_04_1761189-agu-considera-importante-stf-ter-reconhecido-limites-da-denuncia-contra-dilma.shtml.txt
1592,9,1,impeachment-dilma,folha,547,12,13,4,446,30,39,61,www1.folha.uol.com.br___poder_2016_04_1761977-camara-da-aval-a-impeachment-de-dilma-senado-decidira-afastamento.shtml.txt
1593,8,-7,impeachment-dilma,folha,236,14,7,0,200,15,23,19,www1.folha.uol.com.br___poder_2016_04_1762217-manifestantes-pro-e-contra-dilma-rejeitam-temer-aponta-datafolha.shtml.txt
1594,1,0,impeachment-dilma,folha,146,2,2,0,123,4,5,18,www1.folha.uol.com.br___poder_2016_04_1762870-dilma-desce-a-rampa-do-planalto-e-diz-estar-de-alma-lavada.shtml.txt
1595,4,-4,impeachment-dilma,folha,154,6,2,1,127,6,10,20,www1.folha.uol.com.br___poder_2016_04_1763027-bolsonaro-fez-apologia-ao-crime-na-votacao-do-impeachment-diz-oab.shtml.txt
1596,6,1,impeachment-dilma,folha,286,5,6,1,236,8,14,40,www1.folha.uol.com.br___poder_2016_04_1763395-dilma-embarca-para-os-eua-e-reforcara-fala-contra-impeachment.shtml.txt
1597,5,0,impeachment-dilma,folha,297,5,5,1,231,17,22,38,www1.folha.uol.com.br___poder_2016_04_1765178-dilma-admite-que-afastamento-da-presidencia-se-tornou-inevitavel.shtml.txt
1598,4,1,impeachment-dilma,folha,220,4,5,1,183,10,14,23,www1.folha.uol.com.br___poder_2016_05_1767665-dilma-diz-que-plano-safra-nao-serve-de-base-para-seu-impeachment.shtml.txt
1599,0,-1,impeachment-dilma,folha,93,2,1,1,81,2,2,12,www1.folha.uol.com.br___poder_2016_05_1769553-aliado-de-dilma-flavio-dino-ajudou-a-tentar-barrar-impeachment-na-camara.shtml.txt
1600,-21,-6,impeachment-dilma,folha,454,9,3,1,405,32,11,19,www1.folha.uol.com.br___poder_2016_05_1769639-protestos-em-apoio-a-dilma-travam-avenidas-em-sao-paulo.shtml.txt
1601,0,-1,impeachment-dilma,folha,678,14,13,5,563,37,37,73,www1.folha.uol.com.br___poder_2016_05_1770139-senado-afasta-dilma-da-presidencia-e-michel-temer-assume-nesta-quinta.shtml.txt
1602,2,0,impeachment-dilma,folha,149,2,2,0,110,6,8,29,www1.folha.uol.com.br___poder_2016_05_1770321-como-ultimo-ato-dilma-decide-fazer-pronunciamento-no-planalto.shtml.txt
1603,35,-4,impeachment-dilma,folha,991,15,11,4,799,42,77,103,www1.folha.uol.com.br___poder_2016_05_1774018-em-dialogos-gravados-juca-fala-em-pacto-para-deter-avanco-da-lava-jato.shtml.txt
1604,-9,7,impeachment-dilma,folha,531,6,13,0,434,36,27,53,www1.folha.uol.com.br___poder_2016_06_1781414-lewandowski-derruba-ato-de-comissao-e-autoriza-pericia-pedida-por-dilma.shtml.txt
1605,2,-1,impeachment-dilma,folha,198,2,1,0,170,9,11,11,www1.folha.uol.com.br___poder_2016_06_1786207-pericia-do-senado-demonstra-que-impeachment-e-golpe-afirma-dilma.shtml.txt
1606,-1,-1,impeachment-dilma,folha,151,1,0,0,122,9,8,13,www1.folha.uol.com.br___poder_2016_08_1801052-julgamento-final-do-impeachment-podera-ser-a-partir-de-23-de-agosto.shtml.txt
1607,-21,-2,impeachment-dilma,folha,297,8,6,2,244,27,6,36,www1.folha.uol.com.br___poder_2016_08_1806694-dilma-diz-que-vai-ao-senado-para-que-golpe-nunca-mais-aconteca-no-pais.shtml.txt
1608,-3,-2,impeachment-dilma,folha,210,5,3,3,178,14,11,18,www1.folha.uol.com.br___poder_2016_08_1807056-lewandowski-faz-lobby-enquanto-lidera-sessao-do-impeachment.shtml.txt
1609,-8,-1,impeachment-dilma,folha,297,3,2,2,246,17,9,32,www1.folha.uol.com.br___poder_2016_08_1808019-dilma-apresenta-sua-defesa-no-processo-de-impeachment.shtml.txt
1610,-9,-1,impeachment-dilma,folha,446,16,15,1,360,34,25,59,www1.folha.uol.com.br___poder_2016_08_1808274-em-discurso-no-senado-dilma-diz-temer-a-morte-da-democracia.shtml.txt
1611,-13,6,impeachment-dilma,folha,239,2,8,0,176,22,9,42,www1.folha.uol.com.br___poder_2016_08_1808751-apos-impeachment-dilma-mantem-beneficios-como-ex-presidente-do-pais.shtml.txt
1612,5,-3,impeachment-dilma,folha,618,19,16,2,515,25,30,85,www1.folha.uol.com.br___poder_2016_08_1808784-senado-cassa-mandato-de-dilma-congresso-dara-posse-efetiva-a-temer.shtml.txt
1613,15,1,impeachment-dilma,folha,462,9,10,1,368,19,34,61,www1.folha.uol.com.br___poder_2016_08_1808907-votacao-no-senado-para-cassar-dilma-foi-fatiada-entenda.shtml.txt
1614,11,10,impeachment-dilma,folha,524,16,26,5,427,24,35,85,www1.folha.uol.com.br___poder_2016_08_1809106-leia-na-integra-o-discurso-de-dilma-rousseff-apos-o-impeachment.shtml.txt
1615,-5,2,impeachment-dilma,folha,164,2,4,0,127,12,7,24,www1.folha.uol.com.br___poder_2016_09_1809455-apos-impeachment-dilma-decide-se-mudar-para-o-rio.shtml.txt
1616,-6,-4,impeachment-dilma,folha,365,9,5,7,297,26,20,43,www1.folha.uol.com.br___poder_2016_09_1812703-cunha-diz-que-paga-por-impeachment-e-ameaca-colegas.shtml.txt
1617,-4,9,impeachment-dilma,folha,193,1,10,0,167,10,6,21,www1.folha.uol.com.br___poder_2016_09_1817948-impeachment-foi-tropeco-da-democracia-diz-lewandowski.shtml.txt
1618,4,2,reforma-trabalhista,folha,152,1,3,0,128,5,9,14,www1.folha.uol.com.br___poder_2017_03_1866334-frentes-de-esquerda-protestam-na-quarta-contra-reforma-da-previdencia.shtml.txt
1619,-2,-2,afastamento-aecio,folha,199,3,1,2,162,12,10,21,www1.folha.uol.com.br___poder_2017_05_1885399-irma-de-aecio-neves-presa-pela-pf-era-a-estrategista-do-senador-afastado.shtml.txt
1620,8,0,afastamento-aecio,folha,193,2,2,1,152,10,18,18,www1.folha.uol.com.br___poder_2017_05_1885480-jbs-diz-que-pagou-r-60-milhoes-em-propina-para-aecio-neves-em-2014.shtml.txt
1621,-4,-6,afastamento-aecio,folha,452,20,14,3,375,34,30,50,www1.folha.uol.com.br___poder_2017_05_1885945-aecio-neves-vai-de-quase-presidente-a-senador-afastado-e-vive-inferno.shtml.txt
1622,-2,-7,afastamento-aecio,folha,245,8,1,0,192,17,15,30,www1.folha.uol.com.br___poder_2017_05_1885946-investigacao-de-esquema-da-jbs-reune-2-horas-de-videos-e-2200-grampos.shtml.txt
1623,12,-22,afastamento-aecio,folha,588,36,14,3,490,42,54,55,www1.folha.uol.com.br___poder_2017_05_1886464-autora-de-impeachment-de-dilma-se-decepciona-com-aecio-e-rejeita-fhc.shtml.txt
1624,4,-12,reforma-trabalhista,folha,348,15,3,3,266,25,29,49,www1.folha.uol.com.br___poder_2017_05_1886829-aliados-ja-elaboram-planos-para-a-sucessao-de-temer.shtml.txt
1625,16,3,afastamento-aecio,folha,488,11,14,1,413,19,35,47,www1.folha.uol.com.br___poder_2017_05_1886976-e-evidente-a-minha-enorme-tristeza-diz-luciano-huck-sobre-o-amigo-aecio.shtml.txt
1626,-11,-2,afastamento-aecio,folha,216,5,3,1,191,16,5,13,www1.folha.uol.com.br___poder_2017_06_1890209-suposto-cartel-dos-perrella-atuou-em-presidio-de-andrea-neves.shtml.txt
1627,-1,-3,afastamento-aecio,folha,344,5,2,1,291,15,14,32,www1.folha.uol.com.br___poder_2017_06_1891158-jbs-aponta-repasses-para-antonio-andrade-vice-de-pimentel-em-mg.shtml.txt
1628,2,6,afastamento-aecio,folha,330,0,6,4,290,14,16,20,www1.folha.uol.com.br___poder_2017_06_1892757-eunicio-se-reune-com-fachin-para-discutir-afastamento-de-aecio.shtml.txt
1629,-4,4,afastamento-aecio,folha,207,0,4,0,175,16,12,8,www1.folha.uol.com.br___poder_2017_06_1895017-andrea-neves-deixa-a-prisao-em-belo-horizonte.shtml.txt
1630,22,1,afastamento-aecio,folha,773,23,24,5,627,52,74,72,www1.folha.uol.com.br___poder_2017_06_1897359-ministro-do-stf-devolve-mandato-de-aecio-no-senado-e-nega-prisao-do-senador.shtml.txt
1631,-2,3,afastamento-aecio,folha,394,2,5,0,337,20,18,26,www1.folha.uol.com.br___poder_2017_07_1897883-jbs-usava-supermercados-para-pagamento-de-dinheiro-vivo-de-politicos.shtml.txt
1632,1,-4,afastamento-aecio,folha,445,10,6,3,383,23,24,34,www1.folha.uol.com.br___poder_2017_07_1905520-denuncias-ameacam-reeleicao-de-fernando-pimentel-em-minas.shtml.txt
1633,0,1,afastamento-aecio,folha,552,5,6,4,454,38,38,37,www1.folha.uol.com.br___poder_2017_09_1922008-supremo-afasta-aecio-e-determina-recolhimento-noturno.shtml.txt
1634,-10,-6,afastamento-aecio,folha,195,8,2,2,161,18,8,20,www1.folha.uol.com.br___poder_2017_10_1927868-senado-derruba-medidas-cautelares-contra-aecio-neves.shtml.txt
1635,-5,-12,afastamento-aecio,folha,372,13,1,4,313,21,16,40,www1.folha.uol.com.br___poder_2017_11_1934876-evento-do-psdb-sp-tem-coro-de-fora-aecio-e-tentativa-de-pacificacao.shtml.txt
1636,-6,0,afastamento-aecio,folha,175,1,1,1,148,11,5,14,www1.folha.uol.com.br___poder_2017_12_1941365-ministro-do-stf-revoga-prisao-domiciliar-de-irma-de-aecio.shtml.txt
1637,-11,-5,prisao-lula,folha,207,9,4,1,174,22,11,14,www1.folha.uol.com.br___poder_2018_03_ato-de-lula-em-chapeco-tem-petista-inflamado-e-confronto-entre-manifestantes.shtml.txt
1638,3,-2,prisao-lula,folha,165,5,3,0,137,12,15,9,www1.folha.uol.com.br___poder_2018_03_aviao-com-faixa-contra-lula-provoca-apoiadores-do-petista-no-rs.shtml.txt
1639,18,0,prisao-lula,folha,247,9,9,3,200,10,28,30,www1.folha.uol.com.br___poder_2018_03_constituicao-e-clara-ao-vetar-prisao-em-2a-instancia-dizem-especialistas.shtml.txt
1640,3,-7,prisao-lula,folha,254,13,6,1,233,5,8,28,www1.folha.uol.com.br___poder_2018_03_munidos-de-ovos-manifestantes-anti-lula-fazem-carreata-em-curitiba.shtml.txt
1641,16,-6,prisao-lula,folha,447,17,11,4,375,19,35,50,www1.folha.uol.com.br___poder_2018_03_pressionada-carmen-lucia-pauta-julgamento-de-habeas-corpus-de-lula-para-quinta.shtml.txt
1642,14,2,prisao-lula,folha,468,19,21,2,401,23,37,49,www1.folha.uol.com.br___poder_2018_03_se-lula-for-preso-caminho-sera-pedir-habeas-corpus-no-stj-diz-sepulveda.shtml.txt
1643,3,-10,prisao-lula,folha,232,11,1,1,202,8,11,24,www1.folha.uol.com.br___poder_2018_04_advogados-entregam-ao-stf-abaixo-assinado-contra-prisao-apos-segunda-instancia.shtml.txt
1644,2,-1,prisao-lula,folha,269,4,3,0,234,7,9,26,www1.folha.uol.com.br___poder_2018_04_apos-pesquisa-petistas-reafirmam-candidatura-de-lula-e-criticam-datafolha.shtml.txt
1645,-3,-10,prisao-lula,folha,199,13,3,2,174,13,10,20,www1.folha.uol.com.br___poder_2018_04_apos-prisao-de-lula-pt-ainda-e-o-partido-preferido-do-eleitor-diz-datafolha.shtml.txt
1646,5,-6,prisao-lula,folha,531,17,11,4,454,24,29,56,www1.folha.uol.com.br___poder_2018_04_ataque-a-tiros-em-acampamento-pro-lula-em-curitiba-deixa-dois-feridos-diz-pt.shtml.txt
1647,0,-5,prisao-lula,folha,154,6,1,0,134,5,5,17,www1.folha.uol.com.br___poder_2018_04_busca-por-seguidor-de-bolsonaro-marca-manha-em-frente-a-prisao-de-lula.shtml.txt
1648,2,-1,prisao-lula,folha,191,7,6,3,158,11,13,25,www1.folha.uol.com.br___poder_2018_04_com-lula-preso-bolsonaro-mede-palavras-e-mira-ciro.shtml.txt
1649,-2,-1,prisao-lula,folha,134,4,3,1,111,9,7,15,www1.folha.uol.com.br___poder_2018_04_dono-do-bahamas-compra-9000-latas-de-cerveja-para-dar-em-comemoracao-a-prisao-de-lula.shtml.txt
1650,6,1,prisao-lula,folha,235,5,6,1,192,10,16,29,www1.folha.uol.com.br___poder_2018_04_em-curitiba-gleisi-pressiona-rosa-weber-e-diz-que-politicos-tentam-visita-a-lula.shtml.txt
1651,3,-4,prisao-lula,folha,109,9,5,0,96,7,10,10,www1.folha.uol.com.br___poder_2018_04_em-video-antes-de-ser-preso-lula-diz-que-moro-tem-mente-doentia.shtml.txt
1652,10,-1,prisao-lula,folha,248,10,9,3,200,11,21,38,www1.folha.uol.com.br___poder_2018_04_imprensa-internacional-destaca-a-queda-de-um-lider-apos-prisao-de-lula.shtml.txt
1653,9,-5,prisao-lula,folha,324,20,15,0,265,26,35,33,www1.folha.uol.com.br___poder_2018_04_lula-apresentara-2-recursos-ao-supremo.shtml.txt
1654,-15,-29,prisao-lula,folha,670,36,7,3,594,35,20,67,www1.folha.uol.com.br___poder_2018_04_lula-e-preso.shtml.txt
1655,11,9,prisao-lula,folha,315,7,16,3,254,15,26,46,www1.folha.uol.com.br___poder_2018_04_lula-recebe-a-visita-de-parentes-e-acampamento-de-apoiadores-e-alterado.shtml.txt
1656,-7,-2,prisao-lula,folha,202,9,7,1,181,12,5,21,www1.folha.uol.com.br___poder_2018_04_manifestantes-fazem-ato-na-sede-da-globo-em-sp-e-culpam-midia-por-prisao-de-lula.shtml.txt
1657,-7,0,prisao-lula,folha,296,8,8,3,257,23,16,19,www1.folha.uol.com.br___poder_2018_04_moro-decreta-prisao-de-lula-ex-presidente-tem-ate-17h-de-6a-para-se-entregar.shtml.txt
1658,13,3,prisao-lula,folha,359,9,12,0,320,6,19,35,www1.folha.uol.com.br___poder_2018_04_na-vespera-de-julgamento-sobre-lula-comandante-do-exercito-diz-repudiar-impunidade.shtml.txt
1659,-3,-2,prisao-lula,folha,114,5,3,0,91,10,7,14,www1.folha.uol.com.br___poder_2018_04_opositor-de-lula-e-hospitalizado-apos-confusao-no-instituto.shtml.txt
1660,9,-2,prisao-lula,folha,146,5,3,3,123,6,15,13,www1.folha.uol.com.br___poder_2018_04_pdt-tenta-na-justica-autorizacao-para-visita-de-ciro-a-lula.shtml.txt
1661,-2,-2,prisao-lula,folha,656,20,18,5,524,54,52,69,www1.folha.uol.com.br___poder_2018_04_por-6-a-5-supremo-nega-habeas-corpus-para-evitar-prisao-de-lula.shtml.txt
1662,1,-1,prisao-lula,folha,89,1,0,1,75,3,4,9,www1.folha.uol.com.br___poder_2018_04_primo-de-lula-e-baleado-e-morre-no-sabado-da-prisao-do-petista.shtml.txt
1663,-6,1,prisao-lula,folha,146,6,7,0,118,12,6,23,www1.folha.uol.com.br___poder_2018_04_pt-critica-decisao-do-stf-e-grupo-propoe-barreira-humana-contra-prisao.shtml.txt
1664,-4,-8,prisao-lula,folha,270,14,6,1,232,19,15,25,www1.folha.uol.com.br___poder_2018_04_recurso-de-lula-contra-prisao-sera-julgado-pela-segunda-turma-do-stf.shtml.txt
1665,1,-2,prisao-lula,folha,103,4,2,1,86,4,5,15,www1.folha.uol.com.br___poder_2018_04_sem-lula-pt-monta-comando-paralelo-com-ex-ministros.shtml.txt
1666,-2,-9,prisao-lula,folha,407,14,5,2,357,17,15,39,www1.folha.uol.com.br___poder_2018_04_sem-teto-invadem-triplex-em-guaruja-em-protesto-contra-prisao-de-lula.shtml.txt
1667,5,-4,prisao-lula,folha,760,13,9,6,615,38,43,92,www1.folha.uol.com.br___poder_2018_04_trajetoria-de-lula-ate-a-prisao-teve-enredo-de-calvario-e-entrega-em-meio-ao-povo.shtml.txt
1668,-4,1,prisao-lula,folha,239,7,8,0,199,16,12,27,www1.folha.uol.com.br___poder_2018_05_juiz-atende-acao-do-mbl-e-retira-segurancas-motoristas-e-assessores-de-lula.shtml.txt
1669,4,-5,prisao-lula,folha,142,8,3,1,117,7,11,19,www1.folha.uol.com.br___poder_2018_05_prisao-de-lula-completa-um-mes.shtml.txt
1670,6,-1,prisao-lula,folha,235,6,5,4,197,13,19,21,www1.folha.uol.com.br___poder_2018_06_com-ausencia-de-lula-bolsonaro-e-marina-lideram-pesquisa-datafolha.shtml.txt
1671,-2,6,prisao-lula,folha,345,8,14,2,296,24,22,27,www1.folha.uol.com.br___poder_2018_06_em-minas-petistas-lancam-pre-candidatura-de-lula-preso-a-presidencia.shtml.txt
1672,-7,3,prisao-lula,folha,345,9,12,2,312,19,12,25,www1.folha.uol.com.br___poder_2018_06_estou-bonito-hein-diz-lula-antes-do-depoimento-como-testemunha-de-cabral.shtml.txt
1673,2,-5,prisao-lula,folha,101,6,1,1,83,4,6,16,www1.folha.uol.com.br___poder_2018_06_preso-lula-comentara-copa-do-mundo-com-jose-trajano-em-tv-de-sindicato.shtml.txt
1674,-1,-2,prisao-lula,folha,164,9,7,0,138,11,10,21,www1.folha.uol.com.br___poder_2018_07_com-gritos-de-lula-livre-grupo-joga-tinta-vermelha-na-entrada-do-stf.shtml.txt
1675,-1,-8,prisao-lula,folha,539,19,11,4,461,34,33,45,www1.folha.uol.com.br___poder_2018_07_petistas-pediram-habeas-corpus-para-lula-ao-saber-quem-era-juiz-plantonista.shtml.txt
1676,0,-3,prisao-lula,folha,156,6,3,0,133,6,6,20,www1.folha.uol.com.br___poder_2018_07_presidente-do-stj-nega-143-pedidos-iguais-de-habeas-corpus-para-lula.shtml.txt
1677,2,1,prisao-lula,folha,369,6,7,1,302,16,18,47,www1.folha.uol.com.br___poder_2018_07_tre-do-rio-apreende-bandeiras-e-panfletos-em-festival-de-artistas-em-apoio-a-lula.shtml.txt
1678,8,-7,prisao-lula,folha,273,10,3,2,229,16,24,19,www1.folha.uol.com.br___poder_2018_07_tse-nega-pedido-para-declarar-lula-inelegivel-desde-ja.shtml.txt
1679,5,-2,soltura-lula,folha,485,16,14,2,422,28,33,34,www1.folha.uol.com.br___poder_2018_12_marco-aurelio-da-liminar-que-deve-levar-a-soltura-de-lula.shtml.txt
1680,-5,-7,soltura-lula,folha,220,16,9,2,202,19,14,12,www1.folha.uol.com.br___poder_2019_02_alem-do-caso-do-sitio-lula-e-reu-em-outras-7-acoes-penais.shtml.txt
1681,-4,-20,soltura-lula,folha,673,35,15,1,575,52,48,49,www1.folha.uol.com.br___poder_2019_04_stj-julga-nesta-terca-recurso-de-lula-contra-condenacao-do-triplex.shtml.txt
1682,-10,-6,soltura-lula,folha,721,16,10,5,592,54,44,62,www1.folha.uol.com.br___poder_2019_06_lula-tem-derrotas-em-serie-em-pedidos-de-suspeicao-de-juizes-da-lava-jato.shtml.txt
1683,-9,-11,reforma-previdencia,folha,321,13,2,1,252,26,17,42,www1.folha.uol.com.br___poder_2019_07_presidente-do-pdt-promete-atitude-cirurgica-contra-tabata-e-outros-7-dissidentes.shtml.txt
1684,15,6,soltura-lula,folha,327,8,14,0,267,10,25,47,www1.folha.uol.com.br___poder_2019_07_todos-no-stf-tem-couro-suficiente-para-aguentar-qualquer-pressao-diz-toffoli.shtml.txt
1685,16,31,soltura-lula,folha,548,13,44,1,466,27,43,70,www1.folha.uol.com.br___poder_2019_08_juristas-estrangeiros-se-dizem-chocados-e-defendem-libertacao-de-lula.shtml.txt
1686,-30,-1,soltura-lula,folha,703,20,19,1,589,61,31,62,www1.folha.uol.com.br___poder_2019_08_supremo-anula-decisao-de-moro-em-condenacao-da-lava-jato.shtml.txt
1687,1,2,soltura-lula,folha,302,7,9,1,231,20,21,47,www1.folha.uol.com.br___poder_2019_09_maior-derrota-da-lava-jato-mudara-configuracao-politica-do-pais.shtml.txt
1688,9,-7,soltura-lula,folha,586,22,15,2,480,31,40,74,www1.folha.uol.com.br___poder_2019_10_conheca-os-argumentos-contra-e-a-favor-a-prisao-apos-condenacao-em-2a-instancia.shtml.txt
1689,13,0,soltura-lula,folha,189,7,7,1,157,6,19,22,www1.folha.uol.com.br___poder_2019_10_simule-os-possiveis-destinos-de-lula-com-os-julgamentos-previstos-para-este-ano.shtml.txt
1690,11,2,soltura-lula,folha,281,6,8,2,231,17,28,21,www1.folha.uol.com.br___poder_2019_10_veja-embates-recentes-entre-lula-e-a-operacao-lava-jato.shtml.txt
1691,0,-8,soltura-lula,folha,442,22,14,1,376,31,31,41,www1.folha.uol.com.br___poder_2019_11_apos-decisao-do-stf-soltura-de-lula-agora-passa-por-juiza-linha-dura-da-lava-jato.shtml.txt
1692,13,8,soltura-lula,folha,420,7,15,5,343,15,28,61,www1.folha.uol.com.br___poder_2019_11_apos-soltura-de-lula-bolsonaro-adota-o-silencio-e-planalto-se-divide.shtml.txt
1693,9,-2,soltura-lula,folha,478,16,14,5,401,24,33,55,www1.folha.uol.com.br___poder_2019_11_bolsonaro-fala-sobre-soltura-de-lula-e-pede-para-nao-dar-municao-ao-canalha.shtml.txt
1694,8,-3,soltura-lula,folha,350,13,10,4,288,16,24,49,www1.folha.uol.com.br___poder_2019_11_ciro-diz-que-lula-e-encantador-de-serpentes-que-finge-ser-candidato.shtml.txt
1695,-8,-4,soltura-lula,folha,296,20,16,0,253,31,23,25,www1.folha.uol.com.br___poder_2019_11_juizes-mandam-soltar-petista-jose-dirceu-e-ex-tucano-eduardo-azeredo.shtml.txt
1696,5,-1,soltura-lula,folha,571,19,18,4,483,30,35,64,www1.folha.uol.com.br___poder_2019_11_lula-atacar-a-lava-jato-e-diz-nao-ser-pombo-correio-para-usar-tornozeleira-eletronica.shtml.txt
1697,15,-1,soltura-lula,folha,513,15,14,4,413,26,41,66,www1.folha.uol.com.br___poder_2019_11_lula-deve-retomar-agenda-partidaria-e-dar-corda-a-candidatura-em-2022.shtml.txt
1698,-13,-20,soltura-lula,folha,477,30,10,3,393,41,28,58,www1.folha.uol.com.br___poder_2019_11_lula-pede-juizo-ao-congresso-em-discussao-sobre-volta-da-prisao-apos-2a-instancia.shtml.txt
1699,11,4,soltura-lula,folha,290,9,13,2,219,19,30,46,www1.folha.uol.com.br___poder_2019_11_maia-diz-que-congresso-nao-deve-enfrentar-stf-sobre-prisao-apos-2a-instancia.shtml.txt
1700,10,-2,soltura-lula,folha,510,18,16,6,419,31,41,59,www1.folha.uol.com.br___poder_2019_11_stf-enfrentara-acao-sobre-flavio-bolsonaro-depois-de-decisao-que-soltou-lula.shtml.txt
1701,22,9,soltura-lula,folha,927,24,33,6,776,49,71,94,www1.folha.uol.com.br___poder_2019_11_tribunal-eleva-pressao-sobre-stf-ao-usar-brecha-para-condenar-lula-no-caso-do-sitio.shtml.txt
1702,8,-1,soltura-lula,folha,147,4,3,3,123,6,14,14,www1.folha.uol.com.br___poder_2019_11_vou-te-buscar-me-espera-diz-namorada-de-lula.shtml.txt
1703,-4,-9,soltura-lula,folha,515,18,9,10,462,26,22,42,www1.folha.uol.com.br___poder_2019_12_maioria-considera-justa-soltura-de-lula-apos-decisao-do-stf-diz-datafolha.shtml.txt
1704,-3,0,soltura-lula,folha,511,23,23,4,459,28,25,49,www1.folha.uol.com.br___poder_2019_12_para-81-lava-jato-ainda-nao-cumpriu-seu-objetivo-e-deve-continuar-diz-datafolha.shtml.txt
1705,0,6,soltura-lula,folha,461,3,9,4,389,19,19,50,www1.folha.uol.com.br___poder_2019_12_peca-chave-da-lava-jato-sitio-representa-1-do-valor-investigado-no-caso-de-filho-de-lula.shtml.txt
